"","team","game.id","three_pt_Attempts","three_pt_Made","three_pt_Percentage","total_pts.points","opp_three_pt_Attempts","opp_three_pt_Made","opp_three_pt_Percentage","win_team","diff_tpa","diff_tpm","diff_tpp","Percent_of_Points","opp_Percent_of_Points","diff_pop"
"1","bos",33946,32,11,34.4,122,44,15,34.1,1,-12,-4,0.299999999999997,0.270491803278689,0.384615384615385,-0.114123581336696
"2","bos",33955,23,8,34.8,99,25,11,44,0,-2,-3,-9.2,0.242424242424242,0.314285714285714,-0.0718614718614718
"3","bos",33967,31,15,48.4,104,32,9,28.1,1,-1,6,20.3,0.432692307692308,0.275510204081633,0.157182103610675
"4","bos",34001,32,14,43.8,107,20,7,35,1,12,7,8.8,0.392523364485981,0.21,0.182523364485981
"5","bos",34008,32,11,34.4,122,34,14,41.2,0,-2,-3,-6.8,0.270491803278689,0.328125,-0.0576331967213115
"6","bos",34031,25,8,32,107,23,11,47.8,0,2,-3,-15.8,0.224299065420561,0.268292682926829,-0.0439936175062685
"7","bos",34047,31,10,32.3,93,21,10,47.6,0,10,0,-15.3,0.32258064516129,0.254237288135593,0.0683433570256971
"8","bos",34065,27,11,40.7,115,23,6,26.1,1,4,5,14.6,0.28695652173913,0.206896551724138,0.0800599700149925
"9","bos",34070,25,8,32,105,27,6,22.2,1,-2,2,9.8,0.228571428571429,0.181818181818182,0.0467532467532467
"10","bos",34088,41,12,29.3,105,21,6,28.6,0,20,6,0.699999999999999,0.342857142857143,0.169811320754717,0.173045822102426
"11","bos",34101,21,7,33.3,90,23,8,34.8,1,-2,-1,-1.5,0.233333333333333,0.289156626506024,-0.0558232931726907
"12","bos",34119,32,11,34.4,88,28,9,32.1,0,4,2,2.3,0.375,0.259615384615385,0.115384615384615
"13","bos",34128,31,12,38.7,94,20,7,35,1,11,5,3.7,0.382978723404255,0.228260869565217,0.154717853839038
"14","bos",34145,38,12,31.6,99,24,4,16.7,1,14,8,14.9,0.363636363636364,0.129032258064516,0.234604105571848
"15","bos",34157,38,15,39.5,111,31,10,32.3,1,7,5,7.2,0.405405405405405,0.326086956521739,0.0793184488836663
"16","bos",34165,34,12,35.3,103,24,11,45.8,0,10,1,-10.5,0.349514563106796,0.302752293577982,0.0467622695288145
"17","bos",34196,27,11,40.7,112,30,6,20,1,-3,5,20.7,0.294642857142857,0.173076923076923,0.121565934065934
"18","bos",34207,42,15,35.7,114,20,9,45,0,22,6,-9.3,0.394736842105263,0.223140495867769,0.171596346237495
"19","bos",34223,28,11,39.3,97,26,6,23.1,1,2,5,16.2,0.34020618556701,0.195652173913043,0.144554011653967
"20","bos",34234,26,8,30.8,107,33,15,45.4,1,-7,-7,-14.6,0.224299065420561,0.424528301886792,-0.200229236466232
"21","bos",34251,32,11,34.4,106,38,12,31.6,0,-6,-1,2.8,0.311320754716981,0.336448598130841,-0.02512784341386
"22","bos",34262,26,7,26.9,117,26,11,42.3,1,0,-4,-15.4,0.179487179487179,0.379310344827586,-0.199823165340407
"23","bos",34279,42,17,40.5,94,20,9,45,0,22,8,-4.5,0.542553191489362,0.267326732673267,0.275226458816094
"24","bos",34297,32,11,34.4,96,21,3,14.3,0,11,8,20.1,0.34375,0.0909090909090909,0.252840909090909
"25","bos",34323,31,10,32.3,101,22,8,36.4,0,9,2,-4.1,0.297029702970297,0.222222222222222,0.0748074807480748
"26","bos",34331,28,9,32.1,96,30,8,26.7,1,-2,1,5.4,0.28125,0.272727272727273,0.00852272727272729
"27","bos",34350,28,9,32.1,105,24,9,37.5,1,4,0,-5.4,0.257142857142857,0.284210526315789,-0.0270676691729324
"28","bos",34364,37,12,32.4,112,30,12,40,1,7,0,-7.6,0.321428571428571,0.330275229357798,-0.00884665792922673
"29","bos",34380,39,10,25.6,109,23,7,30.4,1,16,3,-4.8,0.275229357798165,0.205882352941176,0.0693470048569887
"30","bos",34385,28,9,32.1,112,26,11,42.3,0,2,-2,-10.2,0.241071428571429,0.282051282051282,-0.0409798534798535
"31","bos",34396,36,14,38.9,119,23,8,34.8,1,13,6,4.1,0.352941176470588,0.210526315789474,0.142414860681115
"32","bos",34412,31,12,38.7,113,30,9,30,1,1,3,8.7,0.31858407079646,0.262135922330097,0.0564481484663631
"33","bos",34428,37,12,32.4,118,38,14,36.8,0,-1,-2,-4.4,0.305084745762712,0.338709677419355,-0.0336249316566429
"34","bos",34434,32,17,53.1,117,28,11,39.3,1,4,6,13.8,0.435897435897436,0.289473684210526,0.14642375168691
"35","bos",34462,31,17,54.8,115,26,11,42.3,1,5,6,12.5,0.443478260869565,0.317307692307692,0.126170568561873
"36","bos",34486,40,19,47.5,110,28,9,32.1,1,12,10,15.4,0.518181818181818,0.254716981132075,0.263464837049743
"37","bos",34493,36,18,50,117,31,10,32.3,1,5,8,17.7,0.461538461538462,0.277777777777778,0.183760683760684
"38","bos",34512,27,9,33.3,106,22,10,45.4,0,5,-1,-12.1,0.254716981132075,0.263157894736842,-0.00844091360476662
"39","bos",34523,41,17,41.5,117,26,10,38.5,1,15,7,3,0.435897435897436,0.277777777777778,0.158119658119658
"40","bos",34537,44,17,38.6,103,29,11,37.9,1,15,6,0.700000000000003,0.495145631067961,0.326732673267327,0.168412957800634
"41","bos",34558,39,15,38.5,108,25,8,32,1,14,7,6.5,0.416666666666667,0.244897959183673,0.171768707482993
"42","bos",34570,33,9,27.3,106,25,10,40,0,8,-1,-12.7,0.254716981132075,0.256410256410256,-0.00169327527818092
"43","bos",34590,35,13,37.1,123,25,10,40,0,10,3,-2.9,0.317073170731707,0.236220472440945,0.0808526982907624
"44","bos",34616,33,10,30.3,108,20,9,45,0,13,1,-14.7,0.277777777777778,0.219512195121951,0.0582655826558266
"45","bos",34621,32,11,34.4,120,31,10,32.3,1,1,1,2.1,0.275,0.275229357798165,-0.000229357798165131
"46","bos",34637,34,16,47.1,128,25,9,36,1,9,7,11.1,0.375,0.275510204081633,0.0994897959183674
"47","bos",34646,40,14,35,112,21,9,42.9,1,19,5,-7.9,0.375,0.25,0.125
"48","bos",34661,32,13,40.6,113,27,3,11.1,1,5,10,29.5,0.345132743362832,0.0825688073394495,0.262563936023382
"49","bos",34672,36,12,33.3,109,31,8,25.8,1,5,4,7.5,0.330275229357798,0.230769230769231,0.0995059985885674
"50","bos",34691,35,13,37.1,113,38,14,36.8,1,-3,-1,0.300000000000004,0.345132743362832,0.392523364485981,-0.0473906211231495
"51","bos",34706,52,16,30.8,107,29,10,34.5,1,23,6,-3.7,0.448598130841121,0.294117647058824,0.154480483782298
"52","bos",34733,32,10,31.2,92,25,10,40,0,7,0,-8.8,0.326086956521739,0.277777777777778,0.0483091787439613
"53","bos",34738,30,10,33.3,120,26,9,34.6,1,4,1,-1.3,0.25,0.243243243243243,0.00675675675675674
"54","bos",34755,30,13,43.3,112,31,8,25.8,1,-1,5,17.5,0.348214285714286,0.230769230769231,0.117445054945055
"55","bos",34766,34,16,47.1,111,27,9,33.3,1,7,7,13.8,0.432432432432432,0.275510204081633,0.1569222283508
"56","bos",34776,28,13,46.4,116,31,8,25.8,1,-3,5,20.6,0.336206896551724,0.222222222222222,0.113984674329502
"57","bos",34789,37,14,37.8,103,25,6,24,0,12,8,13.8,0.407766990291262,0.173076923076923,0.234690067214339
"58","bos",34798,38,12,31.6,97,15,5,33.3,0,23,7,-1.7,0.371134020618557,0.14018691588785,0.230947104730706
"59","bos",34819,35,12,34.3,104,33,12,36.4,1,2,0,-2.1,0.346153846153846,0.36734693877551,-0.0211930926216641
"60","bos",34825,34,10,29.4,98,25,6,24,0,9,4,5.4,0.306122448979592,0.157894736842105,0.148227712137487
"61","bos",34839,31,13,41.9,103,33,10,30.3,1,-2,3,11.6,0.378640776699029,0.303030303030303,0.0756104736687261
"62","bos",34858,33,10,30.3,115,24,6,25,1,9,4,5.3,0.260869565217391,0.189473684210526,0.071395881006865
"63","bos",34869,37,13,35.1,106,20,4,20,0,17,9,15.1,0.367924528301887,0.110091743119266,0.257832785182621
"64","bos",34885,35,10,28.6,102,20,9,45,0,15,1,-16.4,0.294117647058824,0.232758620689655,0.0613590263691684
"65","bos",34899,29,10,34.5,99,30,6,20,1,-1,4,14.5,0.303030303030303,0.209302325581395,0.0937279774489077
"66","bos",34910,33,12,36.4,99,31,12,38.7,0,2,0,-2.3,0.363636363636364,0.302521008403361,0.0611153552330023
"67","bos",34925,37,16,43.2,100,25,7,28,1,12,9,15.2,0.48,0.2625,0.2175
"68","bos",34946,33,13,39.4,117,27,8,29.6,1,6,5,9.8,0.333333333333333,0.230769230769231,0.102564102564103
"69","bos",34962,29,7,24.1,98,35,11,31.4,1,-6,-4,-7.3,0.214285714285714,0.347368421052632,-0.133082706766917
"70","bos",34977,29,6,20.7,99,33,12,36.4,0,-4,-6,-15.7,0.181818181818182,0.342857142857143,-0.161038961038961
"71","bos",34987,33,10,30.3,110,35,8,22.9,1,-2,2,7.4,0.272727272727273,0.235294117647059,0.0374331550802139
"72","bos",35000,27,11,40.7,109,28,11,39.3,1,-1,0,1.40000000000001,0.302752293577982,0.33,-0.0272477064220183
"73","bos",35016,41,14,34.2,130,19,6,31.6,1,22,8,2.6,0.323076923076923,0.15,0.173076923076923
"74","bos",35033,24,8,33.3,112,29,7,24.1,1,-5,1,9.2,0.214285714285714,0.194444444444444,0.0198412698412698
"75","bos",35053,37,12,32.4,100,22,8,36.4,0,15,4,-4,0.36,0.233009708737864,0.126990291262136
"76","bos",35069,33,12,36.4,117,30,12,40,1,3,0,-3.6,0.307692307692308,0.310344827586207,-0.0026525198938992
"77","bos",35082,37,12,32.4,110,25,7,28,1,12,5,4.4,0.327272727272727,0.223404255319149,0.103868471953578
"78","bos",35109,33,7,21.2,91,36,11,30.6,0,-3,-4,-9.4,0.230769230769231,0.289473684210526,-0.0587044534412955
"79","bos",35117,43,15,34.9,116,23,11,47.8,0,20,4,-12.9,0.387931034482759,0.268292682926829,0.119638351555929
"80","bos",35129,39,17,43.6,121,28,9,32.1,1,11,8,11.5,0.421487603305785,0.236842105263158,0.184645498042627
"81","bos",35144,38,14,36.8,114,31,8,25.8,1,7,6,11,0.368421052631579,0.228571428571429,0.13984962406015
"82","bos",35159,37,12,32.4,112,23,6,26.1,1,14,6,6.3,0.321428571428571,0.191489361702128,0.129939209726444
"83","bro",33946,44,15,34.1,117,32,11,34.4,0,12,4,-0.299999999999997,0.384615384615385,0.270491803278689,0.114123581336696
"84","bro",33959,33,10,30.3,103,24,7,29.2,1,9,3,1.1,0.29126213592233,0.223404255319149,0.0678578806031812
"85","bro",33971,34,11,32.4,108,22,8,36.4,0,12,3,-4,0.305555555555556,0.218181818181818,0.0873737373737374
"86","bro",33983,31,5,16.1,88,27,11,40.7,0,4,-6,-24.6,0.170454545454545,0.279661016949153,-0.109206471494607
"87","bro",33997,27,13,48.2,109,25,9,36,1,2,4,12.2,0.357798165137615,0.267326732673267,0.0904714324643474
"88","bro",34012,36,9,25,95,30,10,33.3,0,6,-1,-8.3,0.284210526315789,0.303030303030303,-0.0188197767145136
"89","bro",34041,33,12,36.4,119,28,12,42.9,1,5,0,-6.5,0.302521008403361,0.327272727272727,-0.0247517188693659
"90","bro",34046,33,11,33.3,96,30,10,33.3,0,3,1,0,0.34375,0.272727272727273,0.0710227272727273
"91","bro",34079,37,16,43.2,122,33,8,24.2,1,4,8,19,0.39344262295082,0.230769230769231,0.162673392181589
"92","bro",34092,33,10,30.3,95,25,14,56,0,8,-4,-25.7,0.315789473684211,0.330708661417323,-0.0149191877331123
"93","bro",34097,41,12,29.3,118,28,9,32.1,0,13,3,-2.8,0.305084745762712,0.216,0.0890847457627119
"94","bro",34118,29,11,37.9,105,26,7,26.9,0,3,4,11,0.314285714285714,0.169354838709677,0.144930875576037
"95","bro",34134,35,10,28.6,109,36,15,41.7,0,-1,-5,-13.1,0.275229357798165,0.348837209302326,-0.0736078515041604
"96","bro",34157,31,10,32.3,92,38,15,39.5,0,-7,-5,-7.2,0.326086956521739,0.405405405405405,-0.0793184488836663
"97","bro",34174,34,11,32.4,97,26,11,42.3,0,8,0,-9.9,0.34020618556701,0.279661016949153,0.0605451686178578
"98","bro",34187,39,16,41,105,23,13,56.5,0,16,3,-15.5,0.457142857142857,0.319672131147541,0.137470725995316
"99","bro",34201,38,13,34.2,127,40,13,32.5,1,-2,0,1.7,0.307086614173228,0.319672131147541,-0.0125855169743126
"100","bro",34217,40,12,30,93,34,15,44.1,0,6,-3,-14.1,0.387096774193548,0.405405405405405,-0.0183086312118571
"101","bro",34231,41,11,26.8,103,24,6,25,0,17,5,1.8,0.320388349514563,0.160714285714286,0.159674063800277
"102","bro",34246,27,11,40.7,113,34,14,41.2,0,-7,-3,-0.5,0.292035398230089,0.355932203389831,-0.063896805159742
"103","bro",34263,26,9,34.6,116,37,11,29.7,1,-11,-2,4.9,0.232758620689655,0.297297297297297,-0.0645386766076421
"104","bro",34293,27,7,25.9,101,26,14,53.8,0,1,-7,-27.9,0.207920792079208,0.323076923076923,-0.115156130997715
"105","bro",34304,20,7,35,118,43,17,39.5,0,-23,-10,-4.5,0.177966101694915,0.418032786885246,-0.240066685190331
"106","bro",34318,35,11,31.4,107,27,6,22.2,1,8,5,9.2,0.308411214953271,0.185567010309278,0.122844204643993
"107","bro",34330,27,11,40.7,111,29,7,24.1,0,-2,4,16.6,0.297297297297297,0.177966101694915,0.119331195602382
"108","bro",34348,34,12,35.3,107,28,12,42.9,0,6,0,-7.6,0.336448598130841,0.333333333333333,0.00311526479750779
"109","bro",34360,35,10,28.6,104,18,8,44.4,0,17,2,-15.8,0.288461538461538,0.206896551724138,0.0815649867374005
"110","bro",34377,35,13,37.1,101,37,12,32.4,0,-2,1,4.7,0.386138613861386,0.307692307692308,0.0784463061690784
"111","bro",34384,30,8,26.7,99,35,8,22.9,0,-5,0,3.8,0.242424242424242,0.201680672268908,0.0407435701553349
"112","bro",34403,31,15,48.4,120,26,8,30.8,1,5,7,17.6,0.375,0.203389830508475,0.171610169491525
"113","bro",34420,32,13,40.6,99,13,3,23.1,0,19,10,17.5,0.393939393939394,0.0891089108910891,0.304830483048305
"114","bro",34433,25,10,40,95,22,11,50,0,3,-1,-10,0.315789473684211,0.279661016949153,0.036128456735058
"115","bro",34455,27,6,22.2,89,24,7,29.2,0,3,-1,-7,0.202247191011236,0.207920792079208,-0.00567360106797196
"116","bro",34476,38,17,44.7,109,22,10,45.4,0,16,7,-0.699999999999996,0.467889908256881,0.247933884297521,0.21995602395936
"117","bro",34487,30,9,30,108,33,9,27.3,0,-3,0,2.7,0.25,0.232758620689655,0.0172413793103448
"118","bro",34500,27,10,37,95,27,8,29.6,0,0,2,7.4,0.315789473684211,0.228571428571429,0.0872180451127819
"119","bro",34513,29,10,34.5,97,23,7,30.4,0,6,3,4.1,0.309278350515464,0.179487179487179,0.129791171028284
"120","bro",34527,42,9,21.4,95,32,11,34.4,0,10,-2,-13,0.284210526315789,0.317307692307692,-0.0330971659919028
"121","bro",34533,36,17,47.2,113,28,11,39.3,0,8,6,7.90000000000001,0.451327433628319,0.25,0.201327433628319
"122","bro",34549,44,15,34.1,112,44,21,47.7,0,0,-6,-13.6,0.401785714285714,0.45985401459854,-0.0580683003128258
"123","bro",34562,26,7,26.9,109,19,10,52.6,0,7,-3,-25.7,0.192660550458716,0.252100840336134,-0.0594402898774188
"124","bro",34585,30,15,50,143,34,11,32.4,1,-4,4,17.6,0.314685314685315,0.289473684210526,0.0252116304747884
"125","bro",34592,41,17,41.5,105,29,14,48.3,0,12,3,-6.8,0.485714285714286,0.375,0.110714285714286
"126","bro",34606,25,5,20,86,22,9,40.9,0,3,-4,-20.9,0.174418604651163,0.241071428571429,-0.0666528239202658
"127","bro",34622,35,13,37.1,106,23,11,47.8,0,12,2,-10.7,0.367924528301887,0.302752293577982,0.0651722347239051
"128","bro",34636,33,16,48.5,116,36,13,36.1,0,-3,3,12.4,0.413793103448276,0.314516129032258,0.0992769744160178
"129","bro",34650,21,7,33.3,109,20,9,45,0,1,-2,-11.7,0.192660550458716,0.209302325581395,-0.0166417751226798
"130","bro",34659,26,4,15.4,96,26,11,42.3,0,0,-7,-26.9,0.125,0.317307692307692,-0.192307692307692
"131","bro",34673,25,5,20,90,27,6,22.2,0,-2,-1,-2.2,0.166666666666667,0.189473684210526,-0.0228070175438597
"132","bro",34687,28,11,39.3,97,20,8,40,0,8,3,-0.700000000000003,0.34020618556701,0.226415094339623,0.113791091227388
"133","bro",34705,34,13,38.2,95,19,5,26.3,0,15,8,11.9,0.410526315789474,0.145631067961165,0.264895247828309
"134","bro",34719,36,12,33.3,107,26,7,26.9,0,10,5,6.4,0.336448598130841,0.189189189189189,0.147259408941652
"135","bro",34724,33,9,27.3,110,25,9,36,0,8,0,-8.7,0.245454545454545,0.236842105263158,0.00861244019138757
"136","bro",34739,20,8,40,99,23,7,30.4,0,-3,1,9.6,0.242424242424242,0.194444444444444,0.047979797979798
"137","bro",34762,37,12,32.4,103,22,9,40.9,0,15,3,-8.5,0.349514563106796,0.241071428571429,0.108443134535368
"138","bro",34778,36,14,38.9,125,15,7,46.7,0,21,7,-7.8,0.336,0.162790697674419,0.173209302325581
"139","bro",34804,30,10,33.3,109,31,14,45.2,0,-1,-4,-11.9,0.275229357798165,0.325581395348837,-0.0503520375506721
"140","bro",34813,28,8,28.6,95,31,11,35.5,0,-3,-3,-6.9,0.252631578947368,0.294642857142857,-0.0420112781954887
"141","bro",34845,28,11,39.3,109,22,11,50,1,6,0,-10.7,0.302752293577982,0.33,-0.0272477064220183
"142","bro",34855,29,7,24.1,97,26,12,46.2,0,3,-5,-22.1,0.216494845360825,0.321428571428571,-0.104933726067747
"143","bro",34866,30,14,46.7,116,25,16,64,0,5,-2,-17.3,0.362068965517241,0.369230769230769,-0.00716180371352787
"144","bro",34879,30,14,46.7,122,25,10,40,1,5,4,6.7,0.344262295081967,0.275229357798165,0.0690329372838021
"145","bro",34890,34,11,32.4,105,20,4,20,0,14,7,12.4,0.314285714285714,0.109090909090909,0.205194805194805
"146","bro",34911,31,9,29,96,33,14,42.4,0,-2,-5,-13.4,0.28125,0.4,-0.11875
"147","bro",34926,38,19,50,120,23,8,34.8,1,15,11,15.2,0.475,0.214285714285714,0.260714285714286
"148","bro",34940,24,12,50,104,22,10,45.4,0,2,2,4.6,0.346153846153846,0.245901639344262,0.100252206809584
"149","bro",34956,31,10,32.3,121,16,3,18.8,1,15,7,13.5,0.247933884297521,0.0818181818181818,0.166115702479339
"150","bro",34962,35,11,31.4,95,29,7,24.1,0,6,4,7.3,0.347368421052632,0.214285714285714,0.133082706766917
"151","bro",34976,31,13,41.9,104,25,10,40,0,6,3,1.9,0.375,0.27027027027027,0.10472972972973
"152","bro",34992,29,10,34.5,98,23,5,21.7,1,6,5,12.8,0.306122448979592,0.15625,0.149872448979592
"153","bro",35007,29,8,27.6,126,25,7,28,1,4,1,-0.399999999999999,0.19047619047619,0.214285714285714,-0.0238095238095238
"154","bro",35012,15,3,20,108,26,10,38.5,0,-11,-7,-18.5,0.0833333333333333,0.232558139534884,-0.14922480620155
"155","bro",35028,22,6,27.3,107,27,5,18.5,1,-5,1,8.8,0.168224299065421,0.16304347826087,0.00518082080455098
"156","bro",35045,32,9,28.1,101,33,10,30.3,0,-1,-1,-2.2,0.267326732673267,0.283018867924528,-0.015692135251261
"157","bro",35061,31,10,32.3,89,18,7,38.9,0,13,3,-6.6,0.337078651685393,0.233333333333333,0.10374531835206
"158","bro",35079,31,8,25.8,121,25,10,40,1,6,-2,-14.2,0.198347107438017,0.27027027027027,-0.0719231628322538
"159","bro",35089,33,10,30.3,91,24,7,29.2,1,9,3,1.1,0.32967032967033,0.25609756097561,0.0735727686947199
"160","bro",35094,31,16,51.6,141,38,12,31.6,1,-7,4,20,0.340425531914894,0.305084745762712,0.0353407861521817
"161","bro",35114,30,11,36.7,107,25,9,36,0,5,2,0.700000000000003,0.308411214953271,0.234782608695652,0.0736286062576188
"162","bro",35128,31,10,32.3,107,24,11,45.8,1,7,-1,-13.5,0.280373831775701,0.311320754716981,-0.0309469229412802
"163","bro",35144,31,8,25.8,105,38,14,36.8,0,-7,-6,-11,0.228571428571429,0.368421052631579,-0.13984962406015
"164","bro",35162,33,3,9.1,73,30,14,46.7,0,3,-11,-37.6,0.123287671232877,0.375,-0.251712328767123
"165","nyk",33941,27,9,33.3,88,35,13,37.1,0,-8,-4,-3.8,0.306818181818182,0.333333333333333,-0.0265151515151515
"166","nyk",33968,21,6,28.6,111,25,9,36,1,-4,-3,-7.4,0.162162162162162,0.259615384615385,-0.0974532224532225
"167","nyk",33990,22,7,31.8,89,13,8,61.5,0,9,-1,-29.7,0.235955056179775,0.235294117647059,0.000660938532716454
"168","nyk",33998,20,8,40,99,40,15,37.5,0,-20,-7,2.5,0.242424242424242,0.38135593220339,-0.138931689779147
"169","nyk",34013,21,9,42.9,117,23,8,34.8,1,-2,1,8.1,0.230769230769231,0.230769230769231,0
"170","nyk",34027,20,8,40,109,25,8,32,0,-5,0,8,0.220183486238532,0.210526315789474,0.00965717044905845
"171","nyk",34046,30,10,33.3,110,33,11,33.3,1,-3,-1,0,0.272727272727273,0.34375,-0.0710227272727273
"172","nyk",34065,23,6,26.1,87,27,11,40.7,0,-4,-5,-14.6,0.206896551724138,0.28695652173913,-0.0800599700149925
"173","nyk",34071,23,7,30.4,107,22,7,31.8,0,1,0,-1.4,0.196261682242991,0.177966101694915,0.0182955805480754
"174","nyk",34086,25,9,36,93,27,5,18.5,1,-2,4,17.5,0.290322580645161,0.194805194805195,0.0955173858399665
"175","nyk",34102,25,9,36,105,23,8,34.8,1,2,1,1.2,0.257142857142857,0.235294117647059,0.0218487394957983
"176","nyk",34109,29,12,41.4,112,25,15,60,0,4,-3,-18.6,0.321428571428571,0.378151260504202,-0.0567226890756302
"177","nyk",34133,27,10,37,104,21,6,28.6,1,6,4,8.4,0.288461538461538,0.191489361702128,0.0969721767594108
"178","nyk",34148,29,9,31,107,22,6,27.3,1,7,3,3.7,0.252336448598131,0.174757281553398,0.0775791670447327
"179","nyk",34168,28,11,39.3,113,29,8,27.6,1,-1,3,11.7,0.292035398230089,0.216216216216216,0.0758191820138723
"180","nyk",34181,32,12,37.5,102,22,8,36.4,0,10,4,1.1,0.352941176470588,0.224299065420561,0.128642111050028
"181","nyk",34195,19,6,31.6,103,22,8,36.4,0,-3,-2,-4.8,0.174757281553398,0.214285714285714,-0.0395284327323162
"182","nyk",34211,32,13,40.6,106,19,4,21,1,13,9,19.6,0.367924528301887,0.115384615384615,0.252539912917271
"183","nyk",34225,31,12,38.7,118,28,10,35.7,1,3,2,3,0.305084745762712,0.263157894736842,0.0419268510258698
"184","nyk",34242,29,11,37.9,106,28,9,32.1,1,1,2,5.8,0.311320754716981,0.275510204081633,0.0358105506353485
"185","nyk",34256,25,7,28,114,25,11,44,1,0,-4,-16,0.184210526315789,0.320388349514563,-0.136177823198774
"186","nyk",34267,31,11,35.5,94,40,22,55,0,-9,-11,-19.5,0.351063829787234,0.523809523809524,-0.17274569402229
"187","nyk",34285,29,10,34.5,103,28,7,25,1,1,3,9.5,0.29126213592233,0.21,0.0812621359223301
"188","nyk",34300,22,10,45.4,118,28,10,35.7,1,-6,0,9.7,0.254237288135593,0.267857142857143,-0.0136198547215496
"189","nyk",34312,20,7,35,111,30,9,30,0,-10,-2,5,0.189189189189189,0.238938053097345,-0.0497488639081559
"190","nyk",34328,21,5,23.8,90,32,9,28.1,0,-11,-4,-4.3,0.166666666666667,0.262135922330097,-0.0954692556634304
"191","nyk",34344,23,8,34.8,114,27,10,37,0,-4,-2,-2.2,0.210526315789474,0.236220472440945,-0.0256941566514712
"192","nyk",34361,23,13,56.5,118,23,6,26.1,1,0,7,30.4,0.330508474576271,0.162162162162162,0.168346312414109
"193","nyk",34378,20,9,45,106,27,5,18.5,1,-7,4,26.5,0.254716981132075,0.157894736842105,0.0968222442899702
"194","nyk",34396,23,8,34.8,114,36,14,38.9,0,-13,-6,-4.1,0.210526315789474,0.352941176470588,-0.142414860681115
"195","nyk",34418,27,7,25.9,98,27,7,25.9,0,0,0,0,0.214285714285714,0.205882352941176,0.00840336134453781
"196","nyk",34435,23,7,30.4,92,29,12,41.4,0,-6,-5,-11,0.228260869565217,0.346153846153846,-0.117892976588629
"197","nyk",34445,32,10,31.2,122,55,21,38.2,0,-23,-11,-7,0.245901639344262,0.488372093023256,-0.242470453678994
"198","nyk",34456,21,8,38.1,103,31,15,48.4,0,-10,-7,-10.3,0.233009708737864,0.391304347826087,-0.158294639088223
"199","nyk",34471,28,13,46.4,104,28,9,32.1,0,0,4,14.3,0.375,0.257142857142857,0.117857142857143
"200","nyk",34488,23,13,56.5,116,22,12,54.6,1,1,1,1.9,0.336206896551724,0.324324324324324,0.0118825722273998
"201","nyk",34492,31,12,38.7,109,24,11,45.8,0,7,1,-7.09999999999999,0.330275229357798,0.268292682926829,0.0619825464309689
"202","nyk",34508,29,11,37.9,96,27,12,44.4,0,2,-1,-6.5,0.34375,0.327272727272727,0.0164772727272727
"203","nyk",34520,22,4,18.2,97,28,7,25,0,-6,-3,-6.8,0.123711340206186,0.214285714285714,-0.0905743740795287
"204","nyk",34528,23,7,30.4,104,18,3,16.7,1,5,4,13.7,0.201923076923077,0.101123595505618,0.100799481417459
"205","nyk",34546,29,12,41.4,101,22,8,36.4,0,7,4,5,0.356435643564356,0.206896551724138,0.149539091840218
"206","nyk",34553,26,8,30.8,107,32,12,37.5,0,-6,-4,-6.7,0.224299065420561,0.333333333333333,-0.109034267912773
"207","nyk",34570,25,10,40,117,33,9,27.3,1,-8,1,12.7,0.256410256410256,0.254716981132075,0.00169327527818092
"208","nyk",34578,24,7,29.2,110,32,13,40.6,0,-8,-6,-11.4,0.190909090909091,0.345132743362832,-0.154223652453741
"209","nyk",34594,21,11,52.4,105,24,9,37.5,0,-3,2,14.9,0.314285714285714,0.252336448598131,0.0619492656875835
"210","nyk",34612,22,8,36.4,109,26,7,26.9,1,-4,1,9.5,0.220183486238532,0.203883495145631,0.0162999910929011
"211","nyk",34628,23,7,30.4,95,26,6,23.1,0,-3,1,7.3,0.221052631578947,0.174757281553398,0.0462953500255493
"212","nyk",34639,27,9,33.3,110,37,13,35.1,1,-10,-4,-1.8,0.245454545454545,0.364485981308411,-0.119031435853866
"213","nyk",34651,51,18,35.3,139,31,10,32.3,0,20,8,3,0.388489208633094,0.211267605633803,0.177221602999291
"214","nyk",34664,24,5,20.8,101,22,7,31.8,0,2,-2,-11,0.148514851485149,0.179487179487179,-0.030972328002031
"215","nyk",34673,27,6,22.2,95,25,5,20,1,2,1,2.2,0.189473684210526,0.166666666666667,0.0228070175438597
"216","nyk",34699,31,12,38.7,104,40,16,40,0,-9,-4,-1.3,0.346153846153846,0.432432432432432,-0.0862785862785863
"217","nyk",34708,21,7,33.3,107,28,8,28.6,0,-7,-1,4.7,0.196261682242991,0.198347107438017,-0.00208542519502589
"218","nyk",34731,27,8,29.6,115,25,10,40,0,2,-2,-10.4,0.208695652173913,0.252100840336134,-0.0434051881622214
"219","nyk",34740,38,16,42.1,123,32,16,50,0,6,0,-7.9,0.390243902439024,0.366412213740458,0.0238316886985664
"220","nyk",34757,14,9,64.3,94,29,6,20.7,1,-15,3,43.6,0.287234042553192,0.2,0.0872340425531915
"221","nyk",34785,21,11,52.4,105,23,12,52.2,0,-2,-1,0.199999999999996,0.314285714285714,0.310344827586207,0.00394088669950737
"222","nyk",34793,26,8,30.8,104,38,15,39.5,0,-12,-7,-8.7,0.230769230769231,0.378151260504202,-0.147382029734971
"223","nyk",34808,21,6,28.6,110,31,7,22.6,1,-10,-1,6,0.163636363636364,0.192660550458716,-0.029024186822352
"224","nyk",34822,24,9,37.5,91,26,7,26.9,0,-2,2,10.6,0.296703296703297,0.228260869565217,0.0684424271380793
"225","nyk",34835,29,8,27.6,101,25,5,20,1,4,3,7.6,0.237623762376238,0.166666666666667,0.070957095709571
"226","nyk",34849,21,7,33.3,102,28,9,32.1,0,-7,-2,1.2,0.205882352941176,0.257142857142857,-0.0512605042016807
"227","nyk",34868,22,7,31.8,105,35,13,37.1,0,-13,-6,-5.3,0.2,0.348214285714286,-0.148214285714286
"228","nyk",34875,14,6,42.9,113,32,9,28.1,1,-18,-3,14.8,0.15929203539823,0.257142857142857,-0.097850821744627
"229","nyk",34892,20,7,35,93,26,8,30.8,0,-6,-1,4.2,0.225806451612903,0.230769230769231,-0.00496277915632756
"230","nyk",34915,30,13,43.3,92,27,9,33.3,0,3,4,10,0.423913043478261,0.241071428571429,0.182841614906832
"231","nyk",34926,23,8,34.8,112,38,19,50,0,-15,-11,-15.2,0.214285714285714,0.475,-0.260714285714286
"232","nyk",34941,28,9,32.1,87,29,8,27.6,1,-1,1,4.5,0.310344827586207,0.296296296296296,0.0140485312899106
"233","nyk",34956,16,3,18.8,110,31,10,32.3,0,-15,-7,-13.5,0.0818181818181818,0.247933884297521,-0.166115702479339
"234","nyk",34990,24,6,25,105,31,10,32.3,0,-7,-4,-7.3,0.171428571428571,0.263157894736842,-0.0917293233082707
"235","nyk",35006,21,9,42.9,101,28,7,25,0,-7,2,17.9,0.267326732673267,0.194444444444444,0.0728822882288229
"236","nyk",35011,22,5,22.7,95,21,11,52.4,0,1,-6,-29.7,0.157894736842105,0.3,-0.142105263157895
"237","nyk",35025,10,3,30,98,25,10,40,0,-15,-7,-10,0.0918367346938776,0.283018867924528,-0.191182133230651
"238","nyk",35038,21,7,33.3,109,23,9,39.1,1,-2,-2,-5.8,0.192660550458716,0.284210526315789,-0.0915499758570739
"239","nyk",35055,25,5,20,88,25,12,48,0,0,-7,-28,0.170454545454545,0.342857142857143,-0.172402597402597
"240","nyk",35073,16,6,37.5,98,33,8,24.2,1,-17,-2,13.3,0.183673469387755,0.25531914893617,-0.0716456795484151
"241","nyk",35082,25,7,28,94,37,12,32.4,0,-12,-5,-4.4,0.223404255319149,0.327272727272727,-0.103868471953578
"242","nyk",35100,23,6,26.1,100,27,6,22.2,1,-4,0,3.9,0.18,0.197802197802198,-0.0178021978021978
"243","nyk",35116,20,7,35,103,34,14,41.2,0,-14,-7,-6.2,0.203883495145631,0.39622641509434,-0.192342919948709
"244","nyk",35121,28,6,21.4,88,27,15,55.6,0,1,-9,-34.2,0.204545454545455,0.445544554455446,-0.240999099909991
"245","nyk",35136,28,9,32.1,97,31,10,32.3,0,-3,-1,-0.199999999999996,0.278350515463918,0.272727272727273,0.00562324273664483
"246","nyk",35160,22,9,40.9,114,23,7,30.4,1,-1,2,10.5,0.236842105263158,0.185840707964602,0.0510013972985561
"247","phi",33951,24,7,29.2,97,22,6,27.3,0,2,1,1.9,0.216494845360825,0.174757281553398,0.0417375638074267
"248","phi",33966,18,5,27.8,72,20,5,25,0,-2,0,2.8,0.208333333333333,0.144230769230769,0.0641025641025641
"249","phi",33986,20,9,45,101,25,6,24,0,-5,3,21,0.267326732673267,0.174757281553398,0.0925694511198693
"250","phi",33996,38,12,31.6,93,34,13,38.2,0,4,-1,-6.6,0.387096774193548,0.357798165137615,0.0292986090559337
"251","phi",34020,38,14,36.8,101,38,14,36.8,0,0,0,0,0.415841584158416,0.411764705882353,0.0040768782760629
"252","phi",34033,21,7,33.3,84,19,11,57.9,0,2,-4,-24.6,0.25,0.302752293577982,-0.0527522935779817
"253","phi",34050,36,14,38.9,115,19,9,47.4,0,17,5,-8.5,0.365217391304348,0.221311475409836,0.143905915894512
"254","phi",34061,32,11,34.4,109,19,5,26.3,1,13,6,8.1,0.302752293577982,0.142857142857143,0.159895150720839
"255","phi",34072,29,11,37.9,96,32,13,40.6,0,-3,-2,-2.7,0.34375,0.333333333333333,0.0104166666666667
"256","phi",34089,22,5,22.7,88,40,17,42.5,0,-18,-12,-19.8,0.170454545454545,0.443478260869565,-0.27302371541502
"257","phi",34098,28,10,35.7,109,23,8,34.8,1,5,2,0.900000000000006,0.275229357798165,0.235294117647059,0.0399352401511063
"258","phi",34112,32,9,28.1,86,25,6,24,0,7,3,4.1,0.313953488372093,0.163636363636364,0.150317124735729
"259","phi",34129,35,17,48.6,120,21,6,28.6,1,14,11,20,0.425,0.171428571428571,0.253571428571429
"260","phi",34139,26,11,42.3,101,31,7,22.6,1,-5,4,19.7,0.326732673267327,0.223404255319149,0.103328417948178
"261","phi",34152,36,12,33.3,99,29,10,34.5,0,7,2,-1.2,0.363636363636364,0.288461538461538,0.0751748251748252
"262","phi",34169,22,9,40.9,89,21,6,28.6,0,1,3,12.3,0.303370786516854,0.171428571428571,0.131942215088283
"263","phi",34185,34,15,44.1,108,40,12,30,0,-6,3,14.1,0.416666666666667,0.321428571428571,0.0952380952380952
"264","phi",34194,34,14,41.2,95,19,13,68.4,0,15,1,-27.2,0.442105263157895,0.319672131147541,0.122433132010354
"265","phi",34222,32,9,28.1,88,26,13,50,0,6,-4,-21.9,0.306818181818182,0.371428571428571,-0.0646103896103896
"266","phi",34234,33,15,45.4,106,26,8,30.8,0,7,7,14.6,0.424528301886792,0.224299065420561,0.200229236466232
"267","phi",34244,31,11,35.5,98,27,10,37,0,4,1,-1.5,0.336734693877551,0.283018867924528,0.0537158259530227
"268","phi",34258,41,14,34.2,91,17,2,11.8,0,24,12,22.4,0.461538461538462,0.0625,0.399038461538462
"269","phi",34274,40,12,30,99,25,7,28,1,15,5,2,0.363636363636364,0.238636363636364,0.125
"270","phi",34296,17,7,41.2,97,19,5,26.3,1,-2,2,14.9,0.216494845360825,0.189873417721519,0.0266214276393058
"271","phi",34314,29,9,31,114,29,10,34.5,0,0,-1,-3.5,0.236842105263158,0.24390243902439,-0.00706033376123236
"272","phi",34336,31,6,19.4,89,30,9,30,0,1,-3,-10.6,0.202247191011236,0.27,-0.0677528089887641
"273","phi",34348,28,12,42.9,108,34,12,35.3,1,-6,0,7.6,0.333333333333333,0.336448598130841,-0.00311526479750779
"274","phi",34358,33,11,33.3,93,17,10,58.8,0,16,1,-25.5,0.354838709677419,0.277777777777778,0.0770609318996416
"275","phi",34393,31,13,41.9,116,26,12,46.2,0,5,1,-4.3,0.336206896551724,0.292682926829268,0.0435239697224559
"276","phi",34411,25,9,36,100,25,7,28,0,0,2,8,0.27,0.205882352941176,0.0641176470588236
"277","phi",34429,24,6,25,83,26,15,57.7,0,-2,-9,-32.7,0.216867469879518,0.45,-0.233132530120482
"278","phi",34440,33,16,48.5,124,27,11,40.7,1,6,5,7.8,0.387096774193548,0.270491803278689,0.11660497091486
"279","phi",34461,32,7,21.9,93,24,7,29.2,1,8,0,-7.3,0.225806451612903,0.230769230769231,-0.00496277915632756
"280","phi",34486,28,9,32.1,106,40,19,47.5,0,-12,-10,-15.4,0.254716981132075,0.518181818181818,-0.263464837049743
"281","phi",34500,27,8,29.6,105,27,10,37,1,0,-2,-7.4,0.228571428571429,0.315789473684211,-0.0872180451127819
"282","phi",34520,28,7,25,98,22,4,18.2,1,6,3,6.8,0.214285714285714,0.123711340206186,0.0905743740795287
"283","phi",34532,38,14,36.8,102,23,6,26.1,1,15,8,10.7,0.411764705882353,0.193548387096774,0.218216318785579
"284","phi",34544,31,10,32.3,93,17,8,47.1,0,14,2,-14.8,0.32258064516129,0.220183486238532,0.102397158922758
"285","phi",34555,37,14,37.8,113,14,5,35.7,1,23,9,2.09999999999999,0.371681415929204,0.144230769230769,0.227450646698434
"286","phi",34567,24,8,33.3,94,24,6,25,1,0,2,8.3,0.25531914893617,0.202247191011236,0.0530719579249342
"287","phi",34581,29,12,41.4,93,19,6,31.6,1,10,6,9.8,0.387096774193548,0.195652173913043,0.191444600280505
"288","phi",34593,29,12,41.4,93,20,7,35,0,9,5,6.4,0.387096774193548,0.190909090909091,0.196187683284457
"289","phi",34615,29,10,34.5,121,34,18,52.9,1,-5,-8,-18.4,0.247933884297521,0.490909090909091,-0.24297520661157
"290","phi",34624,26,12,46.2,114,28,7,25,1,-2,5,21.2,0.315789473684211,0.192660550458716,0.123128923225495
"291","phi",34634,25,10,40,118,31,12,38.7,0,-6,-2,1.3,0.254237288135593,0.292682926829268,-0.0384456386936751
"292","phi",34656,28,10,35.7,108,14,8,57.1,0,14,2,-21.4,0.277777777777778,0.198347107438017,0.0794306703397613
"293","phi",34676,22,6,27.3,95,26,10,38.5,0,-4,-4,-11.2,0.189473684210526,0.265486725663717,-0.0760130414531905
"294","phi",34684,25,9,36,86,21,6,28.6,0,4,3,7.4,0.313953488372093,0.176470588235294,0.137482900136799
"295","phi",34698,23,6,26.1,102,22,12,54.6,0,1,-6,-28.5,0.176470588235294,0.288,-0.111529411764706
"296","phi",34713,28,5,17.9,96,22,5,22.7,0,6,0,-4.8,0.15625,0.132743362831858,0.0235066371681416
"297","phi",34722,34,13,38.2,103,22,11,50,0,12,2,-11.8,0.378640776699029,0.297297297297297,0.0813434794017318
"298","phi",34735,28,11,39.3,112,21,10,47.6,1,7,1,-8.3,0.294642857142857,0.27027027027027,0.0243725868725869
"299","phi",34750,25,9,36,117,23,7,30.4,1,2,2,5.6,0.230769230769231,0.192660550458716,0.0381086803105152
"300","phi",34761,33,12,36.4,105,31,11,35.5,1,2,1,0.899999999999999,0.342857142857143,0.333333333333333,0.00952380952380955
"301","phi",34776,31,8,25.8,108,28,13,46.4,0,3,-5,-20.6,0.222222222222222,0.336206896551724,-0.113984674329502
"302","phi",34796,29,10,34.5,120,24,5,20.8,1,5,5,13.7,0.25,0.133928571428571,0.116071428571429
"303","phi",34808,31,7,22.6,109,21,6,28.6,0,10,1,-6,0.192660550458716,0.163636363636364,0.029024186822352
"304","phi",34823,34,10,29.4,108,29,6,20.7,0,5,4,8.7,0.277777777777778,0.151260504201681,0.126517273576097
"305","phi",34838,17,6,35.3,98,30,13,43.3,0,-13,-7,-8,0.183673469387755,0.312,-0.128326530612245
"306","phi",34849,28,9,32.1,105,21,7,33.3,1,7,2,-1.2,0.257142857142857,0.205882352941176,0.0512605042016807
"307","phi",34859,34,14,41.2,106,23,10,43.5,0,11,4,-2.3,0.39622641509434,0.220588235294118,0.175638179800222
"308","phi",34874,30,8,26.7,98,33,14,42.4,0,-3,-6,-15.7,0.244897959183673,0.375,-0.130102040816327
"309","phi",34904,29,11,37.9,108,21,6,28.6,0,8,5,9.3,0.305555555555556,0.157894736842105,0.14766081871345
"310","phi",34914,30,10,33.3,100,25,8,32,0,5,2,1.3,0.3,0.214285714285714,0.0857142857142857
"311","phi",34930,24,10,41.7,118,20,4,20,1,4,6,21.7,0.254237288135593,0.103448275862069,0.150789012273524
"312","phi",34943,27,8,29.6,104,32,14,43.8,0,-5,-6,-14.2,0.230769230769231,0.39622641509434,-0.165457184325109
"313","phi",34960,29,12,41.4,116,23,5,21.7,1,6,7,19.7,0.310344827586207,0.202702702702703,0.107642124883504
"314","phi",34977,33,12,36.4,105,29,6,20.7,1,4,6,15.7,0.342857142857143,0.181818181818182,0.161038961038961
"315","phi",34985,34,9,26.5,109,23,4,17.4,0,11,5,9.1,0.247706422018349,0.107142857142857,0.140563564875491
"316","phi",35002,25,8,32,97,16,4,25,0,9,4,7,0.247422680412371,0.0983606557377049,0.149062024674666
"317","phi",35017,25,8,32,117,24,10,41.7,1,1,-2,-9.7,0.205128205128205,0.280373831775701,-0.0752456266474958
"318","phi",35032,41,14,34.2,94,17,7,41.2,0,24,7,-7,0.446808510638298,0.196261682242991,0.250546828395307
"319","phi",35045,33,10,30.3,106,32,9,28.1,1,1,1,2.2,0.283018867924528,0.267326732673267,0.015692135251261
"320","phi",35051,39,11,28.2,92,18,9,50,0,21,2,-21.8,0.358695652173913,0.272727272727273,0.0859683794466403
"321","phi",35068,33,11,33.3,105,29,13,44.8,0,4,-2,-11.5,0.314285714285714,0.319672131147541,-0.00538641686182673
"322","phi",35088,36,11,30.6,105,19,6,31.6,0,17,5,-1,0.314285714285714,0.15929203539823,0.154993678887484
"323","phi",35094,38,12,31.6,118,31,16,51.6,0,7,-4,-20,0.305084745762712,0.340425531914894,-0.0353407861521817
"324","phi",35113,33,7,21.2,90,25,8,32,0,8,-1,-10.8,0.233333333333333,0.235294117647059,-0.00196078431372548
"325","phi",35131,31,8,25.8,82,27,6,22.2,0,4,2,3.6,0.292682926829268,0.2,0.0926829268292683
"326","phi",35143,33,13,39.4,111,16,5,31.2,0,17,8,8.2,0.351351351351351,0.125,0.226351351351351
"327","phi",35160,23,7,30.4,113,22,9,40.9,0,1,-2,-10.5,0.185840707964602,0.236842105263158,-0.0510013972985561
"328","phi",40227,31,11,35.5,122,29,13,44.8,1,2,-2,-9.3,0.270491803278689,0.327731092436975,-0.0572392891582862
"329","tor",33947,18,3,16.7,109,22,4,18.2,1,-4,-1,-1.5,0.0825688073394495,0.131868131868132,-0.0492993245286823
"330","tor",33958,16,4,25,91,32,12,37.5,0,-16,-8,-12.5,0.131868131868132,0.382978723404255,-0.251110591536123
"331","tor",33982,16,4,25,105,22,9,40.9,1,-6,-5,-15.9,0.114285714285714,0.264705882352941,-0.150420168067227
"332","tor",33995,25,10,40,113,10,3,30,1,15,7,10,0.265486725663717,0.087378640776699,0.178108084887018
"333","tor",34011,25,6,24,96,28,9,32.1,1,-3,-3,-8.1,0.1875,0.310344827586207,-0.122844827586207
"334","tor",34029,30,7,23.3,91,16,5,31.2,0,14,2,-7.9,0.230769230769231,0.15625,0.0745192307692308
"335","tor",34052,26,11,42.3,112,34,12,35.3,1,-8,-1,7,0.294642857142857,0.352941176470588,-0.0582983193277311
"336","tor",34063,22,6,27.3,113,41,17,41.5,1,-19,-11,-14.2,0.15929203539823,0.459459459459459,-0.300167424061229
"337","tor",34071,22,7,31.8,118,23,7,30.4,1,-1,0,1.4,0.177966101694915,0.196261682242991,-0.0182955805480754
"338","tor",34093,29,13,44.8,117,33,13,39.4,0,-4,0,5.4,0.333333333333333,0.322314049586777,0.0110192837465565
"339","tor",34105,25,10,40,121,36,13,36.1,0,-11,-3,3.9,0.247933884297521,0.307086614173228,-0.0591527298757077
"340","tor",34121,23,8,34.8,113,25,4,16,1,-2,4,18.8,0.212389380530973,0.108108108108108,0.104281272422865
"341","tor",34136,24,9,37.5,99,27,11,40.7,0,-3,-2,-3.2,0.272727272727273,0.323529411764706,-0.0508021390374332
"342","tor",34147,19,8,42.1,115,25,10,40,0,-6,-2,2.1,0.208695652173913,0.24390243902439,-0.0352067868504772
"343","tor",34159,23,12,52.2,115,42,14,33.3,1,-19,-2,18.9,0.31304347826087,0.411764705882353,-0.0987212276214833
"344","tor",34172,32,14,43.8,105,29,12,41.4,1,3,2,2.4,0.4,0.363636363636364,0.0363636363636364
"345","tor",34194,19,13,68.4,122,34,14,41.2,1,-15,-1,27.2,0.319672131147541,0.442105263157895,-0.122433132010354
"346","tor",34208,32,16,50,120,27,11,40.7,1,5,5,9.3,0.4,0.314285714285714,0.0857142857142857
"347","tor",34224,29,12,41.4,113,26,6,23.1,1,3,6,18.3,0.31858407079646,0.225,0.0935840707964602
"348","tor",34233,24,13,54.2,128,28,7,25,1,-4,6,29.2,0.3046875,0.25,0.0546875
"349","tor",34245,32,13,40.6,112,32,14,43.8,0,0,-1,-3.2,0.348214285714286,0.362068965517241,-0.0138546798029557
"350","tor",34271,27,12,44.4,124,28,9,32.1,1,-1,3,12.3,0.290322580645161,0.245454545454545,0.0448680351906159
"351","tor",34279,20,9,45,101,42,17,40.5,1,-22,-8,4.5,0.267326732673267,0.542553191489362,-0.275226458816094
"352","tor",34302,25,14,56,122,24,4,16.7,1,1,10,39.3,0.344262295081967,0.12,0.224262295081967
"353","tor",34314,29,10,34.5,123,29,9,31,1,0,1,3.5,0.24390243902439,0.236842105263158,0.00706033376123236
"354","tor",34332,21,10,47.6,121,25,11,44,0,-4,-1,3.6,0.247933884297521,0.264,-0.0160661157024793
"355","tor",34349,27,7,25.9,109,21,3,14.3,1,6,4,11.6,0.192660550458716,0.113924050632911,0.0787364998258042
"356","tor",34360,18,8,44.4,116,35,10,28.6,1,-17,-2,15.8,0.206896551724138,0.288461538461538,-0.0815649867374005
"357","tor",34392,21,8,38.1,104,27,10,37,1,-6,-2,1.1,0.230769230769231,0.306122448979592,-0.0753532182103611
"358","tor",34409,34,12,35.3,95,23,8,34.8,1,11,4,0.5,0.378947368421053,0.263736263736264,0.115211104684789
"359","tor",34425,35,13,37.1,111,23,14,60.9,0,12,-1,-23.8,0.351351351351351,0.347107438016529,0.00424391333482244
"360","tor",34430,27,7,25.9,91,21,9,42.9,0,6,-2,-17,0.230769230769231,0.272727272727273,-0.0419580419580419
"361","tor",34452,17,10,58.8,123,32,15,46.9,1,-15,-5,11.9,0.24390243902439,0.394736842105263,-0.150834403080873
"362","tor",34465,18,4,22.2,82,24,13,54.2,0,-6,-9,-32,0.146341463414634,0.354545454545455,-0.20820399113082
"363","tor",34477,21,8,38.1,101,20,7,35,1,1,1,3.1,0.237623762376238,0.225806451612903,0.0118173107633344
"364","tor",34494,31,8,25.8,118,28,11,39.3,0,3,-3,-13.5,0.203389830508475,0.268292682926829,-0.0649028524183547
"365","tor",34503,25,11,44,122,38,11,29,0,-13,0,15,0.270491803278689,0.255813953488372,0.0146778497903164
"366","tor",34512,22,10,45.4,114,27,9,33.3,1,-5,1,12.1,0.263157894736842,0.254716981132075,0.00844091360476662
"367","tor",34533,28,11,39.3,132,36,17,47.2,1,-8,-6,-7.90000000000001,0.25,0.451327433628319,-0.201327433628319
"368","tor",34546,22,8,36.4,116,29,12,41.4,1,-7,-4,-5,0.206896551724138,0.356435643564356,-0.149539091840218
"369","tor",34562,19,10,52.6,119,26,7,26.9,1,-7,3,25.7,0.252100840336134,0.192660550458716,0.0594402898774188
"370","tor",34567,24,6,25,89,24,8,33.3,0,0,-2,-8.3,0.202247191011236,0.25531914893617,-0.0530719579249342
"371","tor",34582,30,7,23.3,78,25,12,48,0,5,-5,-24.7,0.269230769230769,0.31858407079646,-0.049353301565691
"372","tor",34603,27,7,25.9,103,22,9,40.9,0,5,-2,-15,0.203883495145631,0.234782608695652,-0.0308991135500211
"373","tor",34614,25,6,24,106,24,7,29.2,0,1,-1,-5.2,0.169811320754717,0.194444444444444,-0.0246331236897275
"374","tor",34625,34,10,29.4,99,22,10,45.4,0,12,0,-16,0.303030303030303,0.297029702970297,0.00600060006000602
"375","tor",34638,25,10,40,102,23,7,30.4,1,2,3,9.6,0.294117647058824,0.244186046511628,0.0499316005471956
"376","tor",34655,28,12,42.9,113,23,10,43.5,0,5,2,-0.600000000000001,0.31858407079646,0.263157894736842,0.0554261760596181
"377","tor",34665,31,10,32.3,108,30,12,40,1,1,-2,-7.7,0.277777777777778,0.339622641509434,-0.0618448637316562
"378","tor",34672,31,8,25.8,104,36,12,33.3,0,-5,-4,-7.5,0.230769230769231,0.330275229357798,-0.0995059985885674
"379","tor",34686,28,10,35.7,94,14,5,35.7,0,14,5,0,0.319148936170213,0.147058823529412,0.172090112640801
"380","tor",34705,19,5,26.3,103,34,13,38.2,1,-15,-8,-11.9,0.145631067961165,0.410526315789474,-0.264895247828309
"381","tor",34711,24,10,41.7,118,35,13,37.1,1,-11,-3,4.6,0.254237288135593,0.357798165137615,-0.103560877002021
"382","tor",34730,28,11,39.3,109,19,7,36.8,0,9,4,2.5,0.302752293577982,0.1875,0.115252293577982
"383","tor",34758,16,8,50,101,31,8,25.8,0,-15,0,24.2,0.237623762376238,0.235294117647059,0.00232964472917879
"384","tor",34771,20,5,25,94,17,7,41.2,0,3,-2,-16.2,0.159574468085106,0.2,-0.0404255319148936
"385","tor",34777,32,12,37.5,90,38,13,34.2,1,-6,-1,3.3,0.4,0.458823529411765,-0.0588235294117647
"386","tor",34798,15,5,33.3,107,38,12,31.6,1,-23,-7,1.7,0.14018691588785,0.371134020618557,-0.230947104730706
"387","tor",34818,20,7,35,112,21,9,42.9,1,-1,-2,-7.9,0.1875,0.254716981132075,-0.0672169811320755
"388","tor",34822,26,7,26.9,92,24,9,37.5,1,2,-2,-10.6,0.228260869565217,0.296703296703297,-0.0684424271380793
"389","tor",34836,20,7,35,96,25,9,36,0,-5,-2,-1,0.21875,0.257142857142857,-0.0383928571428571
"390","tor",34850,25,11,44,114,30,10,33.3,1,-5,1,10.7,0.289473684210526,0.283018867924528,0.00645481628599803
"391","tor",34860,21,7,33.3,94,27,6,22.2,0,-6,1,11.1,0.223404255319149,0.178217821782178,0.0451864335369707
"392","tor",34893,21,8,38.1,94,29,9,31,1,-8,-1,7.1,0.25531914893617,0.310344827586207,-0.0550256786500367
"393","tor",34909,25,4,16,99,22,8,36.4,0,3,-4,-20.4,0.121212121212121,0.228571428571429,-0.107359307359307
"394","tor",34919,15,2,13.3,89,28,11,39.3,0,-13,-9,-26,0.0674157303370786,0.317307692307692,-0.249891961970614
"395","tor",34932,25,9,36,100,25,7,28,1,0,2,8,0.27,0.269230769230769,0.0007692307692308
"396","tor",34955,20,5,25,102,25,14,56,0,-5,-9,-31,0.147058823529412,0.341463414634146,-0.194404591104735
"397","tor",34963,27,9,33.3,87,20,3,15,1,7,6,18.3,0.310344827586207,0.12,0.190344827586207
"398","tor",34980,27,12,44.4,116,23,6,26.1,1,4,6,18.3,0.310344827586207,0.197802197802198,0.112542629784009
"399","tor",34991,23,8,34.8,122,37,14,37.8,1,-14,-6,-3,0.19672131147541,0.35,-0.15327868852459
"400","tor",35008,23,6,26.1,101,23,6,26.1,1,0,0,0,0.178217821782178,0.214285714285714,-0.0360678925035361
"401","tor",35024,21,9,42.9,94,28,7,25,1,-7,2,17.9,0.287234042553192,0.244186046511628,0.0430479960415636
"402","tor",35037,15,10,66.7,131,20,4,20,1,-5,6,46.7,0.229007633587786,0.107142857142857,0.121864776444929
"403","tor",35054,31,11,35.5,106,32,16,50,0,-1,-5,-14.5,0.311320754716981,0.436363636363636,-0.125042881646655
"404","tor",35066,27,14,51.8,111,26,11,42.3,1,1,3,9.5,0.378378378378378,0.33,0.0483783783783784
"405","tor",35088,19,6,31.6,113,36,11,30.6,1,-17,-5,1,0.15929203539823,0.314285714285714,-0.154993678887484
"406","tor",35097,23,5,21.7,90,25,12,48,0,-2,-7,-26.3,0.166666666666667,0.333333333333333,-0.166666666666667
"407","tor",35106,30,10,33.3,105,21,7,33.3,1,9,3,0,0.285714285714286,0.205882352941176,0.0798319327731092
"408","tor",35120,20,9,45,96,23,8,34.8,1,-3,1,10.2,0.28125,0.25531914893617,0.0259308510638298
"409","tor",35136,31,10,32.3,110,28,9,32.1,1,3,1,0.199999999999996,0.272727272727273,0.278350515463918,-0.00562324273664483
"410","tor",35158,26,8,30.8,98,37,10,27,1,-11,-2,3.8,0.244897959183673,0.36144578313253,-0.116547823948857
"411","gsw",33943,33,7,21.2,100,24,12,50,0,9,-5,-28.8,0.21,0.27906976744186,-0.0690697674418605
"412","gsw",33965,28,9,32.1,122,22,5,22.7,1,6,4,9.4,0.221311475409836,0.131578947368421,0.089732528041415
"413","gsw",33976,29,8,27.6,106,23,8,34.8,1,6,0,-7.2,0.226415094339623,0.24,-0.0135849056603773
"414","gsw",33994,26,10,38.5,127,39,14,35.9,1,-13,-4,2.6,0.236220472440945,0.403846153846154,-0.167625681405209
"415","gsw",34009,30,14,46.7,122,27,10,37,1,3,4,9.7,0.344262295081967,0.3125,0.0317622950819672
"416","gsw",34018,32,5,15.6,97,30,8,26.7,0,2,-3,-11.1,0.154639175257732,0.205128205128205,-0.0504890298704732
"417","gsw",34039,35,16,45.7,116,21,7,33.3,1,14,9,12.4,0.413793103448276,0.19811320754717,0.215679895901106
"418","gsw",34056,33,17,51.5,116,28,6,21.4,1,5,11,30.1,0.439655172413793,0.189473684210526,0.250181488203267
"419","gsw",34059,30,14,46.7,125,36,13,36.1,1,-6,1,10.6,0.336,0.386138613861386,-0.0501386138613861
"420","gsw",34083,33,16,48.5,133,24,8,33.3,1,9,8,15.2,0.360902255639098,0.2,0.160902255639098
"421","gsw",34105,36,13,36.1,127,25,10,40,1,11,3,-3.9,0.307086614173228,0.247933884297521,0.0591527298757077
"422","gsw",34119,28,9,32.1,104,32,11,34.4,1,-4,-2,-2.3,0.259615384615385,0.375,-0.115384615384615
"423","gsw",34131,38,14,36.8,124,20,10,50,1,18,4,-13.2,0.338709677419355,0.247933884297521,0.0907757931218341
"424","gsw",34142,36,13,36.1,120,23,6,26.1,1,13,7,10,0.325,0.216867469879518,0.108132530120482
"425","gsw",34163,36,19,52.8,149,20,8,40,1,16,11,12.8,0.38255033557047,0.226415094339623,0.156135241230847
"426","gsw",34178,28,11,39.3,109,22,5,22.7,1,6,6,16.6,0.302752293577982,0.176470588235294,0.126281705342688
"427","gsw",34184,22,11,50,115,35,10,28.6,1,-13,1,21.4,0.28695652173913,0.294117647058824,-0.0071611253196931
"428","gsw",34199,35,12,34.3,105,29,7,24.1,1,6,5,10.2,0.342857142857143,0.21,0.132857142857143
"429","gsw",34221,44,12,27.3,127,44,14,31.8,0,0,-2,-4.5,0.283464566929134,0.318181818181818,-0.0347172512526843
"430","gsw",34239,21,14,66.7,138,32,11,34.4,1,-11,3,32.3,0.304347826086957,0.302752293577982,0.00159553250897487
"431","gsw",34254,37,14,37.8,142,15,3,20,1,22,11,17.8,0.295774647887324,0.0849056603773585,0.210868987509965
"432","gsw",34270,30,7,23.3,115,26,8,30.8,1,4,-1,-7.5,0.182608695652174,0.244897959183673,-0.0622892635314996
"433","gsw",34275,29,12,41.4,106,38,10,26.3,1,-9,2,15.1,0.339622641509434,0.303030303030303,0.0365923384791309
"434","gsw",34291,27,9,33.3,89,26,8,30.8,0,1,1,2.5,0.303370786516854,0.218181818181818,0.0851889683350358
"435","gsw",34298,32,13,40.6,116,24,9,37.5,1,8,4,3.1,0.336206896551724,0.25,0.0862068965517241
"436","gsw",34311,34,14,41.2,113,35,14,40,1,-1,0,1.2,0.371681415929204,0.385321100917431,-0.0136396849882277
"437","gsw",34328,32,9,28.1,103,21,5,23.8,1,11,4,4.3,0.262135922330097,0.166666666666667,0.0954692556634304
"438","gsw",34345,28,14,50,135,28,8,28.6,1,0,6,21.4,0.311111111111111,0.266666666666667,0.0444444444444445
"439","gsw",34367,23,9,39.1,104,30,9,30,1,-7,0,9.1,0.259615384615385,0.364864864864865,-0.10524948024948
"440","gsw",34377,37,12,32.4,117,35,13,37.1,1,2,-1,-4.7,0.307692307692308,0.386138613861386,-0.0784463061690784
"441","gsw",34386,27,11,40.7,119,29,10,34.5,1,-2,1,6.2,0.277310924369748,0.265486725663717,0.0118241987060311
"442","gsw",34397,30,9,30,108,35,12,34.3,0,-5,-3,-4.3,0.25,0.330275229357798,-0.0802752293577982
"443","gsw",34425,23,14,60.9,121,35,13,37.1,1,-12,1,23.8,0.347107438016529,0.351351351351351,-0.00424391333482244
"444","gsw",34441,33,11,33.3,108,32,8,25,1,1,3,8.3,0.305555555555556,0.242424242424242,0.0631313131313131
"445","gsw",34460,25,11,44,127,35,9,25.7,1,-10,2,18.3,0.259842519685039,0.226890756302521,0.0329517633825183
"446","gsw",34474,36,13,36.1,125,26,12,46.2,1,10,1,-10.1,0.312,0.307692307692308,0.00430769230769229
"447","gsw",34490,30,8,26.7,119,33,13,39.4,0,-3,-5,-12.7,0.201680672268908,0.3046875,-0.103006827731092
"448","gsw",34506,29,10,34.5,117,28,11,39.3,1,1,-1,-4.8,0.256410256410256,0.311320754716981,-0.0549104983067247
"449","gsw",34518,27,11,40.7,107,30,6,20,1,-3,5,20.7,0.308411214953271,0.189473684210526,0.118937530742745
"450","gsw",34531,29,15,51.7,127,28,6,21.4,1,1,9,30.3,0.354330708661417,0.168224299065421,0.186106409595997
"451","gsw",34559,34,15,44.1,126,34,9,26.5,1,0,6,17.6,0.357142857142857,0.296703296703297,0.0604395604395604
"452","gsw",34574,21,10,47.6,121,28,8,28.6,1,-7,2,19,0.247933884297521,0.24,0.00793388429752068
"453","gsw",34586,38,15,39.5,125,35,7,20,1,3,8,19.5,0.36,0.194444444444444,0.165555555555556
"454","gsw",34601,42,19,45.2,118,28,7,25,1,14,12,20.2,0.483050847457627,0.214285714285714,0.268765133171913
"455","gsw",34608,30,8,26.7,102,30,13,43.3,0,0,-5,-16.6,0.235294117647059,0.371428571428571,-0.136134453781513
"456","gsw",34627,28,11,39.3,113,23,7,30.4,1,5,4,8.9,0.292035398230089,0.203883495145631,0.0881519030844574
"457","gsw",34647,34,17,50,144,28,12,42.9,1,6,5,7.1,0.354166666666667,0.36734693877551,-0.0131802721088435
"458","gsw",34658,26,8,30.8,113,27,10,37,1,-1,-2,-6.2,0.212389380530973,0.27027027027027,-0.0578808897392968
"459","gsw",34681,48,21,43.8,126,30,9,30,1,18,12,13.8,0.5,0.243243243243243,0.256756756756757
"460","gsw",34685,34,14,41.2,133,25,10,40,1,9,4,1.2,0.315789473684211,0.25,0.0657894736842105
"461","gsw",34704,44,15,34.1,106,23,7,30.4,0,21,8,3.7,0.424528301886792,0.192660550458716,0.231867751428077
"462","gsw",34732,28,15,53.6,123,24,4,16.7,1,4,11,36.9,0.365853658536585,0.130434782608696,0.23541887592789
"463","gsw",34743,33,15,45.4,122,26,9,34.6,1,7,6,10.8,0.368852459016393,0.252336448598131,0.116516010418263
"464","gsw",34752,31,13,41.9,130,24,6,25,1,7,7,16.9,0.3,0.157894736842105,0.142105263157895
"465","gsw",34767,32,8,25,110,40,24,60,0,-8,-16,-35,0.218181818181818,0.545454545454545,-0.327272727272727
"466","gsw",34787,36,13,36.1,109,24,7,29.2,1,12,6,6.9,0.357798165137615,0.244186046511628,0.113612118625987
"467","gsw",34794,25,13,52,123,28,11,39.3,1,-3,2,12.7,0.317073170731707,0.292035398230089,0.0250377725016188
"468","gsw",34813,31,11,35.5,112,28,8,28.6,1,3,3,6.9,0.294642857142857,0.252631578947368,0.0420112781954887
"469","gsw",34823,29,6,20.7,119,34,10,29.4,1,-5,-4,-8.7,0.151260504201681,0.277777777777778,-0.126517273576097
"470","gsw",34829,28,8,28.6,108,28,12,42.9,0,0,-4,-14.3,0.222222222222222,0.321428571428571,-0.0992063492063492
"471","gsw",34846,30,6,20,87,19,5,26.3,0,11,1,-6.3,0.206896551724138,0.159574468085106,0.0473220836390315
"472","gsw",34868,35,13,37.1,112,22,7,31.8,1,13,6,5.3,0.348214285714286,0.2,0.148214285714286
"473","gsw",34877,44,20,45.4,119,28,13,46.4,1,16,7,-1,0.504201680672269,0.351351351351351,0.152850329320918
"474","gsw",34899,30,6,20,86,29,10,34.5,0,1,-4,-14.5,0.209302325581395,0.303030303030303,-0.0937279774489077
"475","gsw",34908,24,7,29.2,102,14,4,28.6,0,10,3,0.599999999999998,0.205882352941176,0.116504854368932,0.0893774985722444
"476","gsw",34920,17,5,29.4,85,27,12,44.4,0,-10,-7,-15,0.176470588235294,0.336448598130841,-0.159978009895547
"477","gsw",34943,32,14,43.8,106,27,8,29.6,1,5,6,14.2,0.39622641509434,0.230769230769231,0.165457184325109
"478","gsw",34959,26,10,38.5,122,27,7,25.9,1,-1,3,12.6,0.245901639344262,0.228260869565217,0.0176407697790449
"479","gsw",34975,23,12,52.2,117,27,9,33.3,1,-4,3,18.9,0.307692307692308,0.293478260869565,0.0142140468227425
"480","gsw",34989,33,15,45.4,111,21,4,19,1,12,11,26.4,0.405405405405405,0.126315789473684,0.279089615931721
"481","gsw",34995,30,13,43.3,112,34,11,32.4,1,-4,2,10.9,0.348214285714286,0.379310344827586,-0.0310960591133005
"482","gsw",35021,31,10,32.3,114,21,10,47.6,1,10,0,-15.3,0.263157894736842,0.3,-0.0368421052631579
"483","gsw",35034,31,17,54.8,106,29,8,27.6,1,2,9,27.2,0.481132075471698,0.25531914893617,0.225812926535528
"484","gsw",35048,41,11,26.8,113,31,5,16.1,1,10,6,10.7,0.292035398230089,0.141509433962264,0.150525964267824
"485","gsw",35058,26,13,50,110,24,9,37.5,1,2,4,12.5,0.354545454545455,0.275510204081633,0.0790352504638219
"486","gsw",35076,32,11,34.4,107,37,12,32.4,1,-5,-1,2,0.308411214953271,0.36734693877551,-0.0589357238222392
"487","gsw",35092,36,16,44.4,139,27,10,37,1,9,6,7.4,0.345323741007194,0.260869565217391,0.084454175789803
"488","gsw",35102,32,14,43.8,121,19,4,21,1,13,10,22.8,0.347107438016529,0.11214953271028,0.234957905306249
"489","gsw",35111,31,13,41.9,120,27,7,25.9,1,4,6,16,0.325,0.189189189189189,0.135810810810811
"490","gsw",35135,33,10,30.3,123,21,5,23.8,1,12,5,6.5,0.24390243902439,0.148514851485149,0.0953875875392417
"491","gsw",35151,25,9,36,99,35,13,37.1,0,-10,-4,-1.1,0.272727272727273,0.371428571428571,-0.0987012987012987
"492","gsw",35169,36,12,33.3,109,17,4,23.5,1,19,8,9.8,0.330275229357798,0.127659574468085,0.202615654889713
"493","lac",33957,29,8,27.6,114,18,4,22.2,1,11,4,5.4,0.210526315789474,0.113207547169811,0.0973187686196623
"494","lac",33975,27,6,22.2,88,19,7,36.8,1,8,-1,-14.6,0.204545454545455,0.28,-0.0754545454545455
"495","lac",33985,16,6,37.5,116,15,5,33.3,1,1,1,4.2,0.155172413793103,0.153061224489796,0.00211118930330753
"496","lac",34004,22,7,31.8,83,20,5,25,0,2,2,6.8,0.253012048192771,0.176470588235294,0.0765414599574769
"497","lac",34014,27,8,29.6,99,26,9,34.6,1,1,-1,-5,0.242424242424242,0.306818181818182,-0.0643939393939394
"498","lac",34026,23,9,39.1,116,25,10,40,1,-2,-1,-0.899999999999999,0.232758620689655,0.326086956521739,-0.093328335832084
"499","lac",34038,25,13,52,114,12,4,33.3,1,13,9,18.7,0.342105263157895,0.146341463414634,0.195763799743261
"500","lac",34055,32,11,34.4,111,30,6,20,1,2,5,14.4,0.297297297297297,0.225,0.0722972972972973
"501","lac",34066,27,11,40.7,110,28,16,57.1,1,-1,-5,-16.4,0.3,0.444444444444444,-0.144444444444444
"502","lac",34075,24,11,45.8,119,22,8,36.4,1,2,3,9.4,0.277310924369748,0.228571428571429,0.0487394957983193
"503","lac",34092,25,14,56,127,33,10,30.3,1,-8,4,25.7,0.330708661417323,0.315789473684211,0.0149191877331123
"504","lac",34107,25,9,36,107,26,15,57.7,0,-1,-6,-21.7,0.252336448598131,0.405405405405405,-0.153068956807275
"505","lac",34123,29,13,44.8,121,26,10,38.5,1,3,3,6.3,0.322314049586777,0.260869565217391,0.0614444843693855
"506","lac",34132,27,11,40.7,102,30,9,30,1,-3,2,10.7,0.323529411764706,0.284210526315789,0.0393188854489164
"507","lac",34147,25,10,40,123,19,8,42.1,1,6,2,-2.1,0.24390243902439,0.208695652173913,0.0352067868504772
"508","lac",34160,32,15,46.9,124,24,11,45.8,1,8,4,1.1,0.362903225806452,0.317307692307692,0.0455955334987593
"509","lac",34170,21,7,33.3,97,19,9,47.4,0,2,-2,-14.1,0.216494845360825,0.25,-0.0335051546391752
"510","lac",34189,24,4,16.7,70,19,5,26.3,0,5,-1,-9.6,0.171428571428571,0.164835164835165,0.0065934065934066
"511","lac",34201,40,13,32.5,122,38,13,34.2,0,2,0,-1.7,0.319672131147541,0.307086614173228,0.0125855169743126
"512","lac",34219,31,13,41.9,113,24,9,37.5,1,7,4,4.4,0.345132743362832,0.287234042553192,0.0578987008096403
"513","lac",34227,24,10,41.7,114,20,5,25,1,4,5,16.7,0.263157894736842,0.15625,0.106907894736842
"514","lac",34243,30,10,33.3,102,14,5,35.7,0,16,5,-2.40000000000001,0.294117647058824,0.135135135135135,0.158982511923688
"515","lac",34270,26,8,30.8,98,30,7,23.3,0,-4,1,7.5,0.244897959183673,0.182608695652174,0.0622892635314996
"516","lac",34295,36,17,47.2,133,19,8,42.1,1,17,9,5.1,0.383458646616541,0.228571428571429,0.154887218045113
"517","lac",34306,23,11,47.8,121,21,10,47.6,1,2,1,0.199999999999996,0.272727272727273,0.25,0.0227272727272727
"518","lac",34316,25,13,52,113,33,14,42.4,1,-8,-1,9.6,0.345132743362832,0.388888888888889,-0.0437561455260571
"519","lac",34337,25,7,28,102,27,6,22.2,1,-2,1,5.8,0.205882352941176,0.183673469387755,0.0222088835534213
"520","lac",34346,24,7,29.2,110,19,10,52.6,0,5,-3,-23.4,0.190909090909091,0.256410256410256,-0.0655011655011655
"521","lac",34366,36,16,44.4,119,39,11,28.2,1,-3,5,16.2,0.403361344537815,0.323529411764706,0.0798319327731092
"522","lac",34381,28,11,39.3,106,19,6,31.6,1,9,5,7.7,0.311320754716981,0.178217821782178,0.133102932934803
"523","lac",34395,29,13,44.8,88,29,7,24.1,0,0,6,20.7,0.443181818181818,0.233333333333333,0.209848484848485
"524","lac",34400,29,10,34.5,102,25,8,32,0,4,2,2.5,0.294117647058824,0.216216216216216,0.0779014308426073
"525","lac",34410,25,9,36,102,31,11,35.5,0,-6,-2,0.5,0.264705882352941,0.311320754716981,-0.0466148723640399
"526","lac",34436,33,13,39.4,116,40,14,35,0,-7,-1,4.4,0.336206896551724,0.3,0.0362068965517242
"527","lac",34447,30,8,26.7,88,29,10,34.5,0,1,-2,-7.8,0.272727272727273,0.263157894736842,0.00956937799043062
"528","lac",34459,16,7,43.8,109,15,2,13.3,1,1,5,30.5,0.192660550458716,0.0612244897959184,0.131436060662797
"529","lac",34473,23,9,39.1,115,28,11,39.3,1,-5,-2,-0.199999999999996,0.234782608695652,0.311320754716981,-0.0765381460213289
"530","lac",34491,31,13,41.9,106,30,9,30,1,1,4,11.9,0.367924528301887,0.275510204081633,0.0924143242202541
"531","lac",34501,30,9,30,98,27,7,25.9,1,3,2,4.1,0.275510204081633,0.244186046511628,0.0313241575700047
"532","lac",34524,26,9,34.6,105,27,6,22.2,1,-1,3,12.4,0.257142857142857,0.1875,0.0696428571428571
"533","lac",34541,28,10,35.7,113,21,10,47.6,1,7,0,-11.9,0.265486725663717,0.309278350515464,-0.0437916248517471
"534","lac",34561,28,12,42.9,120,30,10,33.3,1,-2,2,9.6,0.3,0.306122448979592,-0.00612244897959185
"535","lac",34580,22,4,18.2,101,16,5,31.2,0,6,-1,-13,0.118811881188119,0.144230769230769,-0.0254188880426504
"536","lac",34598,32,10,31.2,98,24,10,41.7,0,8,0,-10.5,0.306122448979592,0.24390243902439,0.0622200099552016
"537","lac",34607,24,14,58.3,115,29,9,31,1,-5,5,27.3,0.365217391304348,0.257142857142857,0.108074534161491
"538","lac",34615,34,18,52.9,110,29,10,34.5,0,5,8,18.4,0.490909090909091,0.247933884297521,0.24297520661157
"539","lac",34647,28,12,42.9,98,34,17,50,0,-6,-5,-7.1,0.36734693877551,0.354166666666667,0.0131802721088435
"540","lac",34679,19,5,26.3,124,20,7,35,1,-1,-2,-8.7,0.120967741935484,0.184210526315789,-0.0632427843803056
"541","lac",34685,25,10,40,120,34,14,41.2,0,-9,-4,-1.2,0.25,0.315789473684211,-0.0657894736842105
"542","lac",34706,29,10,34.5,102,52,16,30.8,0,-23,-6,3.7,0.294117647058824,0.448598130841121,-0.154480483782298
"543","lac",34711,35,13,37.1,109,24,10,41.7,0,11,3,-4.6,0.357798165137615,0.254237288135593,0.103560877002021
"544","lac",34731,25,10,40,119,27,8,29.6,1,-2,2,10.4,0.252100840336134,0.208695652173913,0.0434051881622214
"545","lac",34748,34,14,41.2,107,37,13,35.1,1,-3,1,6.1,0.392523364485981,0.382352941176471,0.0101704233095107
"546","lac",34768,25,9,36,88,23,4,17.4,1,2,5,18.6,0.306818181818182,0.166666666666667,0.140151515151515
"547","lac",34786,37,14,37.8,99,26,7,26.9,1,11,7,10.9,0.424242424242424,0.25,0.174242424242424
"548","lac",34794,28,11,39.3,113,25,13,52,0,3,-2,-12.7,0.292035398230089,0.317073170731707,-0.0250377725016188
"549","lac",34805,23,7,30.4,97,26,9,34.6,0,-3,-2,-4.2,0.216494845360825,0.257142857142857,-0.0406480117820324
"550","lac",34821,32,10,31.2,124,40,18,45,1,-8,-8,-13.8,0.241935483870968,0.446280991735537,-0.204345507864569
"551","lac",34844,34,12,35.3,103,52,20,38.5,0,-18,-8,-3.2,0.349514563106796,0.491803278688525,-0.142288715581728
"552","lac",34852,19,8,42.1,101,25,10,40,0,-6,-2,2.1,0.237623762376238,0.267857142857143,-0.0302333804809052
"553","lac",34862,25,6,24,101,17,6,35.3,1,8,0,-11.3,0.178217821782178,0.197802197802198,-0.0195843760200196
"554","lac",34885,20,9,45,116,35,10,28.6,1,-15,-1,16.4,0.232758620689655,0.294117647058824,-0.0613590263691684
"555","lac",34895,24,9,37.5,91,20,5,25,0,4,4,12.5,0.296703296703297,0.14018691588785,0.156516380815446
"556","lac",34901,30,11,36.7,114,20,7,35,1,10,4,1.7,0.289473684210526,0.214285714285714,0.0751879699248121
"557","lac",34914,25,8,32,112,30,10,33.3,1,-5,-2,-1.3,0.214285714285714,0.3,-0.0857142857142857
"558","lac",34936,30,12,40,108,21,14,66.7,0,9,-2,-26.7,0.333333333333333,0.368421052631579,-0.0350877192982456
"559","lac",34953,24,5,20.8,96,29,10,34.5,0,-5,-5,-13.7,0.15625,0.309278350515464,-0.153028350515464
"560","lac",34958,32,16,50,114,28,15,53.6,0,4,1,-3.6,0.421052631578947,0.348837209302326,0.0722154222766218
"561","lac",34971,26,8,30.8,108,27,5,18.5,1,-1,3,12.3,0.222222222222222,0.192307692307692,0.0299145299145299
"562","lac",34990,31,10,32.3,114,24,6,25,1,7,4,7.3,0.263157894736842,0.171428571428571,0.0917293233082707
"563","lac",34998,33,15,45.4,133,20,6,30,1,13,9,15.4,0.338345864661654,0.165137614678899,0.173208249982755
"564","lac",35009,27,9,33.3,95,26,9,34.6,0,1,0,-1.3,0.284210526315789,0.278350515463918,0.00586001085187193
"565","lac",35022,27,7,25.9,108,26,8,30.8,1,1,-1,-4.9,0.194444444444444,0.252631578947368,-0.058187134502924
"566","lac",35029,29,10,34.5,97,28,13,46.4,0,1,-3,-11.9,0.309278350515464,0.397959183673469,-0.0886808331580055
"567","lac",35059,30,12,40,133,34,13,38.2,1,-4,-1,1.8,0.270676691729323,0.314516129032258,-0.0438394373029348
"568","lac",35064,22,12,54.6,124,23,7,30.4,1,-1,5,24.2,0.290322580645161,0.177966101694915,0.112356478950246
"569","lac",35077,25,11,44,115,23,6,26.1,1,2,5,17.9,0.28695652173913,0.173076923076923,0.113879598662207
"570","lac",35112,31,12,38.7,112,31,11,35.5,1,0,1,3.2,0.321428571428571,0.326732673267327,-0.00530410183875529
"571","lac",35133,22,6,27.3,98,22,8,36.4,1,0,-2,-9.1,0.183673469387755,0.275862068965517,-0.0921885995777621
"572","lac",35150,26,10,38.5,125,40,9,22.5,1,-14,1,16,0.24,0.28125,-0.04125
"573","lac",35168,28,10,35.7,115,11,5,45.4,1,17,5,-9.7,0.260869565217391,0.157894736842105,0.102974828375286
"574","lac",40246,37,11,29.7,98,29,10,34.5,0,8,1,-4.8,0.336734693877551,0.294117647058824,0.0426170468187275
"575","lal",33953,35,12,34.3,120,29,7,24.1,1,6,5,10.2,0.3,0.184210526315789,0.115789473684211
"576","lal",33964,23,9,39.1,89,25,6,24,0,-2,3,15.1,0.303370786516854,0.1875,0.115870786516854
"577","lal",33980,32,7,21.9,96,26,9,34.6,0,6,-2,-12.7,0.21875,0.238938053097345,-0.0201880530973451
"578","lal",33988,28,6,21.4,108,28,10,35.7,0,0,-4,-14.3,0.166666666666667,0.260869565217391,-0.0942028985507246
"579","lal",33999,22,9,40.9,123,32,11,34.4,1,-10,-2,6.5,0.219512195121951,0.28448275862069,-0.0649705634987384
"580","lal",34018,30,8,26.7,117,32,5,15.6,1,-2,3,11.1,0.205128205128205,0.154639175257732,0.0504890298704732
"581","lal",34032,23,10,43.5,119,20,6,30,1,3,4,13.5,0.252100840336134,0.166666666666667,0.0854341736694678
"582","lal",34044,26,10,38.5,97,23,10,43.5,0,3,0,-5,0.309278350515464,0.275229357798165,0.0340489927172988
"583","lal",34060,27,9,33.3,101,21,8,38.1,1,6,1,-4.8,0.267326732673267,0.263736263736264,0.0035904689370036
"584","lal",34069,30,16,53.3,126,20,6,30,1,10,10,23.3,0.380952380952381,0.181818181818182,0.199134199134199
"585","lal",34082,24,8,33.3,99,27,13,48.2,0,-3,-5,-14.9,0.242424242424242,0.312,-0.0695757575757576
"586","lal",34097,28,9,32.1,125,41,12,29.3,1,-13,-3,2.8,0.216,0.305084745762712,-0.0890847457627119
"587","lal",34122,25,12,48,107,24,10,41.7,0,1,2,6.3,0.336448598130841,0.258620689655172,0.0778279084756687
"588","lal",34138,31,13,41.9,110,22,8,36.4,0,9,5,5.5,0.354545454545455,0.203389830508475,0.15115562403698
"589","lal",34151,27,14,51.8,111,27,11,40.7,1,0,3,11.1,0.378378378378378,0.302752293577982,0.0756260848003967
"590","lal",34163,20,8,40,106,36,19,52.8,0,-16,-11,-12.8,0.226415094339623,0.38255033557047,-0.156135241230847
"591","lal",34178,22,5,22.7,85,28,11,39.3,0,-6,-6,-16.6,0.176470588235294,0.302752293577982,-0.126281705342688
"592","lal",34192,20,8,40,109,35,12,34.3,1,-15,-4,5.7,0.220183486238532,0.382978723404255,-0.162795237165723
"593","lal",34203,30,5,16.7,88,31,8,25.8,0,-1,-3,-9.1,0.170454545454545,0.228571428571429,-0.0581168831168831
"594","lal",34209,8,2,25,96,21,4,19,1,-13,-2,6,0.0625,0.133333333333333,-0.0708333333333333
"595","lal",34224,26,6,23.1,80,29,12,41.4,0,-3,-6,-18.3,0.225,0.31858407079646,-0.0935840707964602
"596","lal",34235,21,7,33.3,100,30,10,33.3,0,-9,-3,0,0.21,0.29126213592233,-0.0812621359223301
"597","lal",34253,14,5,35.7,101,32,13,40.6,0,-18,-8,-4.9,0.148514851485149,0.364485981308411,-0.215971129823263
"598","lal",34266,20,5,25,95,36,15,41.7,0,-16,-10,-16.7,0.157894736842105,0.335820895522388,-0.177926158680283
"599","lal",34284,26,9,34.6,115,30,13,43.3,0,-4,-4,-8.7,0.234782608695652,0.327731092436975,-0.0929484837413226
"600","lal",34300,28,10,35.7,112,22,10,45.4,0,6,0,-9.7,0.267857142857143,0.254237288135593,0.0136198547215496
"601","lal",34307,23,10,43.5,92,23,10,43.5,0,0,0,0,0.326086956521739,0.258620689655172,0.0674662668665667
"602","lal",34318,27,6,22.2,97,35,11,31.4,0,-8,-5,-9.2,0.185567010309278,0.308411214953271,-0.122844204643993
"603","lal",34336,30,9,30,100,31,6,19.4,1,-1,3,10.6,0.27,0.202247191011236,0.0677528089887641
"604","lal",34342,37,16,43.2,108,33,15,45.4,0,4,1,-2.2,0.444444444444444,0.378151260504202,0.0662931839402428
"605","lal",34359,33,16,48.5,113,25,11,44,0,8,5,4.5,0.424778761061947,0.282051282051282,0.142727479010665
"606","lal",34379,38,14,36.8,107,22,11,50,0,16,3,-13.2,0.392523364485981,0.28695652173913,0.105566842746851
"607","lal",34383,23,8,34.8,90,27,11,40.7,0,-4,-3,-5.90000000000001,0.266666666666667,0.302752293577982,-0.036085626911315
"608","lal",34400,25,8,32,111,29,10,34.5,1,-4,-2,-2.5,0.216216216216216,0.294117647058824,-0.0779014308426073
"609","lal",34415,16,4,25,100,26,9,34.6,0,-10,-5,-9.6,0.12,0.264705882352941,-0.144705882352941
"610","lal",34431,19,7,36.8,89,31,14,45.2,0,-12,-7,-8.40000000000001,0.235955056179775,0.415841584158416,-0.179886527978641
"611","lal",34452,32,15,46.9,114,17,10,58.8,0,15,5,-11.9,0.394736842105263,0.24390243902439,0.150834403080873
"612","lal",34468,33,17,51.5,116,31,10,32.3,1,2,7,19.2,0.439655172413793,0.294117647058824,0.14553752535497
"613","lal",34482,31,10,32.3,109,33,12,36.4,0,-2,-2,-4.1,0.275229357798165,0.305084745762712,-0.0298553879645467
"614","lal",34489,28,10,35.7,127,32,8,25,1,-4,2,10.7,0.236220472440945,0.24,-0.00377952755905511
"615","lal",34507,32,8,25,111,26,7,26.9,1,6,1,-1.9,0.216216216216216,0.221052631578947,-0.00483641536273113
"616","lal",34517,24,9,37.5,87,21,7,33.3,0,3,2,4.2,0.310344827586207,0.194444444444444,0.115900383141762
"617","lal",34529,19,6,31.6,94,21,10,47.6,0,-2,-4,-16,0.191489361702128,0.223880597014925,-0.0323912353127977
"618","lal",34541,21,10,47.6,97,28,10,35.7,0,-7,0,11.9,0.309278350515464,0.265486725663717,0.0437916248517471
"619","lal",34552,26,6,23.1,97,25,9,36,0,1,-3,-12.9,0.185567010309278,0.264705882352941,-0.0791388720436628
"620","lal",34566,30,11,36.7,121,26,11,42.3,0,4,0,-5.59999999999999,0.272727272727273,0.259842519685039,0.0128847530422334
"621","lal",34589,33,14,42.4,108,24,10,41.7,1,9,4,0.699999999999996,0.388888888888889,0.3125,0.0763888888888889
"622","lal",34602,21,3,14.3,73,39,17,43.6,0,-18,-14,-29.3,0.123287671232877,0.418032786885246,-0.294745115652369
"623","lal",34629,29,11,37.9,98,15,4,26.7,0,14,7,11.2,0.336734693877551,0.114285714285714,0.222448979591837
"624","lal",34633,14,4,28.6,88,26,6,23.1,0,-12,-2,5.5,0.136363636363636,0.1875,-0.0511363636363636
"625","lal",34669,26,12,46.2,120,27,15,55.6,1,-1,-3,-9.4,0.3,0.387931034482759,-0.0879310344827586
"626","lal",34682,39,12,30.8,108,33,12,36.4,0,6,0,-5.6,0.333333333333333,0.310344827586207,0.0229885057471264
"627","lal",34691,38,14,36.8,107,35,13,37.1,0,3,1,-0.300000000000004,0.392523364485981,0.345132743362832,0.0473906211231495
"628","lal",34708,28,8,28.6,121,21,7,33.3,1,7,1,-4.7,0.198347107438017,0.196261682242991,0.00208542519502589
"629","lal",34726,23,6,26.1,102,16,4,25,0,7,2,1.1,0.176470588235294,0.0991735537190083,0.0772970345162859
"630","lal",34742,30,15,50,122,28,8,28.6,1,2,7,21.4,0.368852459016393,0.210526315789474,0.15832614322692
"631","lal",34773,29,12,41.4,96,24,7,29.2,0,5,5,12.2,0.375,0.216494845360825,0.158505154639175
"632","lal",34784,26,9,34.6,101,24,10,41.7,0,2,-1,-7.1,0.267326732673267,0.218978102189781,0.0483486304834863
"633","lal",34801,35,7,20,93,24,10,41.7,0,11,-3,-21.7,0.225806451612903,0.272727272727273,-0.0469208211143695
"634","lal",34814,22,7,31.8,98,21,10,47.6,0,1,-3,-15.8,0.214285714285714,0.252100840336134,-0.0378151260504202
"635","lal",34834,32,12,37.5,104,39,16,41,0,-7,-4,-3.5,0.346153846153846,0.440366972477064,-0.0942131263232181
"636","lal",34858,24,6,25,95,33,10,30.3,0,-9,-4,-5.3,0.189473684210526,0.260869565217391,-0.071395881006865
"637","lal",34873,28,10,35.7,97,24,9,37.5,0,4,1,-1.8,0.309278350515464,0.257142857142857,0.0521354933726068
"638","lal",34887,30,11,36.7,111,31,17,54.8,0,-1,-6,-18.1,0.297297297297297,0.418032786885246,-0.120735489587949
"639","lal",34903,27,12,44.4,122,19,6,31.6,1,8,6,12.8,0.295081967213115,0.163636363636364,0.131445603576751
"640","lal",34930,20,4,20,116,24,10,41.7,0,-4,-6,-21.7,0.103448275862069,0.254237288135593,-0.150789012273524
"641","lal",34938,20,6,30,101,38,17,44.7,0,-18,-11,-14.7,0.178217821782178,0.395348837209302,-0.217131015427124
"642","lal",34950,25,3,12,100,43,18,41.9,0,-18,-15,-29.9,0.09,0.388489208633094,-0.298489208633094
"643","lal",34967,29,11,37.9,103,24,4,16.7,0,5,7,21.2,0.320388349514563,0.11214953271028,0.208238816804283
"644","lal",34983,27,11,40.7,120,36,13,36.1,0,-9,-2,4.6,0.275,0.312,-0.037
"645","lal",34998,20,6,30,109,33,15,45.4,0,-13,-9,-15.4,0.165137614678899,0.338345864661654,-0.173208249982755
"646","lal",35020,23,14,60.9,130,21,7,33.3,1,2,7,27.6,0.323076923076923,0.176470588235294,0.146606334841629
"647","lal",35036,21,5,23.8,81,28,12,42.9,0,-7,-7,-19.1,0.185185185185185,0.371134020618557,-0.185948835433372
"648","lal",35050,22,8,36.4,108,23,6,26.1,0,-1,2,10.3,0.222222222222222,0.151260504201681,0.0709617180205415
"649","lal",35063,27,9,33.3,104,21,10,47.6,0,6,-1,-14.3,0.259615384615385,0.252100840336134,0.00751454427925019
"650","lal",35077,23,6,26.1,104,25,11,44,0,-2,-5,-17.9,0.173076923076923,0.28695652173913,-0.113879598662207
"651","lal",35084,19,7,36.8,108,30,13,43.3,1,-11,-6,-6.5,0.194444444444444,0.378640776699029,-0.184196332254585
"652","lal",35110,14,7,50,102,35,13,37.1,1,-21,-6,12.9,0.205882352941176,0.410526315789474,-0.204643962848297
"653","lal",35127,24,4,16.7,98,20,8,40,1,4,-4,-23.3,0.122448979591837,0.25531914893617,-0.132870169344333
"654","lal",35142,27,10,37,110,16,3,18.8,1,11,7,18.2,0.272727272727273,0.0825688073394495,0.190158465387823
"655","lal",35155,22,8,36.4,108,22,7,31.8,1,0,1,4.6,0.222222222222222,0.21875,0.00347222222222221
"656","lal",35169,17,4,23.5,94,36,12,33.3,0,-19,-8,-9.8,0.127659574468085,0.330275229357798,-0.202615654889713
"657","phx",33952,16,4,25,94,21,6,28.6,0,-5,-2,-3.6,0.127659574468085,0.15929203539823,-0.031632460930145
"658","phx",33961,28,5,17.9,110,21,5,23.8,0,7,0,-5.9,0.136363636363636,0.132743362831858,0.00362027353177793
"659","phx",33976,23,8,34.8,100,29,8,27.6,0,-6,0,7.2,0.24,0.226415094339623,0.0135849056603773
"660","phx",33985,15,5,33.3,98,16,6,37.5,0,-1,-1,-4.2,0.153061224489796,0.155172413793103,-0.00211118930330753
"661","phx",34003,16,5,31.2,118,33,12,36.4,1,-17,-7,-5.2,0.127118644067797,0.31304347826087,-0.185924834193073
"662","phx",34015,24,8,33.3,112,30,10,33.3,1,-6,-2,0,0.214285714285714,0.27027027027027,-0.055984555984556
"663","phx",34032,20,6,30,108,23,10,43.5,0,-3,-4,-13.5,0.166666666666667,0.252100840336134,-0.0854341736694678
"664","phx",34043,21,7,33.3,121,31,14,45.2,0,-10,-7,-11.9,0.173553719008264,0.338709677419355,-0.16515595841109
"665","phx",34053,22,8,36.4,107,22,9,40.9,1,0,-1,-4.5,0.224299065420561,0.27,-0.0457009345794393
"666","phx",34079,33,8,24.2,104,37,16,43.2,0,-4,-8,-19,0.230769230769231,0.39344262295082,-0.162673392181589
"667","phx",34083,24,8,33.3,120,33,16,48.5,0,-9,-8,-15.2,0.2,0.360902255639098,-0.160902255639098
"668","phx",34106,20,8,40,104,17,8,47.1,0,3,0,-7.1,0.230769230769231,0.2,0.0307692307692308
"669","phx",34115,26,9,34.6,116,7,1,14.3,1,19,8,20.3,0.232758620689655,0.03125,0.201508620689655
"670","phx",34129,21,6,28.6,105,35,17,48.6,0,-14,-11,-20,0.171428571428571,0.425,-0.253571428571429
"671","phx",34140,27,11,40.7,101,28,10,35.7,0,-1,1,5,0.326732673267327,0.283018867924528,0.0437138053427985
"672","phx",34154,22,9,40.9,92,25,7,28,1,-3,2,12.9,0.293478260869565,0.241379310344828,0.0520989505247376
"673","phx",34176,26,6,23.1,85,22,7,31.8,0,4,-1,-8.7,0.211764705882353,0.214285714285714,-0.00252100840336134
"674","phx",34186,25,11,44,114,29,13,44.8,0,-4,-2,-0.799999999999997,0.289473684210526,0.325,-0.0355263157894737
"675","phx",34214,21,10,47.6,109,25,9,36,1,-4,1,11.6,0.275229357798165,0.252336448598131,0.0228929092000343
"676","phx",34239,32,11,34.4,109,21,14,66.7,0,11,-3,-32.3,0.302752293577982,0.304347826086957,-0.00159553250897487
"677","phx",34260,18,6,33.3,105,27,12,44.4,0,-9,-6,-11.1,0.171428571428571,0.321428571428571,-0.15
"678","phx",34269,33,9,27.3,94,23,7,30.4,0,10,2,-3.1,0.287234042553192,0.192660550458716,0.0945734920944759
"679","phx",34284,30,13,43.3,119,26,9,34.6,1,4,4,8.7,0.327731092436975,0.234782608695652,0.0929484837413226
"680","phx",34299,41,14,34.2,119,40,16,40,0,1,-2,-5.8,0.352941176470588,0.4,-0.0470588235294118
"681","phx",34312,30,9,30,113,20,7,35,1,10,2,-5,0.238938053097345,0.189189189189189,0.0497488639081559
"682","phx",34339,22,8,36.4,101,16,7,43.8,0,6,1,-7.4,0.237623762376238,0.184210526315789,0.0534132360604481
"683","phx",34356,21,9,42.9,108,19,7,36.8,0,2,2,6.1,0.25,0.182608695652174,0.0673913043478261
"684","phx",34375,25,9,36,111,38,18,47.4,0,-13,-9,-11.4,0.243243243243243,0.432,-0.188756756756757
"685","phx",34393,26,12,46.2,123,31,13,41.9,1,-5,-1,4.3,0.292682926829268,0.336206896551724,-0.0435239697224559
"686","phx",34407,30,7,23.3,115,43,15,34.9,0,-13,-8,-11.6,0.182608695652174,0.343511450381679,-0.160902754729505
"687","phx",34422,16,7,43.8,98,17,5,29.4,0,-1,2,14.4,0.214285714285714,0.126050420168067,0.0882352941176471
"688","phx",34430,21,9,42.9,99,27,7,25.9,1,-6,2,17,0.272727272727273,0.230769230769231,0.0419580419580419
"689","phx",34446,17,7,41.2,86,20,8,40,0,-3,-1,1.2,0.244186046511628,0.263736263736264,-0.0195502172246358
"690","phx",34459,15,2,13.3,98,16,7,43.8,0,-1,-5,-30.5,0.0612244897959184,0.192660550458716,-0.131436060662797
"691","phx",34467,23,9,39.1,99,23,6,26.1,1,0,3,13,0.272727272727273,0.2,0.0727272727272727
"692","phx",34481,17,7,41.2,102,29,9,31,1,-12,-2,10.2,0.205882352941176,0.284210526315789,-0.078328173374613
"693","phx",34505,27,9,33.3,116,34,15,44.1,0,-7,-6,-10.8,0.232758620689655,0.375,-0.142241379310345
"694","phx",34530,18,10,55.6,108,34,15,44.1,0,-16,-5,11.5,0.277777777777778,0.398230088495575,-0.120452310717797
"695","phx",34543,21,8,38.1,108,20,9,45,1,1,-1,-6.9,0.222222222222222,0.257142857142857,-0.0349206349206349
"696","phx",34560,22,5,22.7,101,23,8,34.8,0,-1,-3,-12.1,0.148514851485149,0.226415094339623,-0.0779002428544741
"697","phx",34576,19,4,21,103,43,19,44.2,0,-24,-15,-23.2,0.116504854368932,0.483050847457627,-0.366545993088695
"698","phx",34594,24,9,37.5,107,21,11,52.4,1,3,-2,-14.9,0.252336448598131,0.314285714285714,-0.0619492656875835
"699","phx",34603,22,9,40.9,115,27,7,25.9,1,-5,2,15,0.234782608695652,0.203883495145631,0.0308991135500211
"700","phx",34619,19,7,36.8,111,17,6,35.3,0,2,1,1.5,0.189189189189189,0.160714285714286,0.0284749034749035
"701","phx",34632,24,10,41.7,120,23,9,39.1,0,1,1,2.6,0.25,0.21259842519685,0.0374015748031496
"702","phx",34649,21,6,28.6,112,25,8,32,0,-4,-2,-3.4,0.160714285714286,0.195121951219512,-0.0344076655052265
"703","phx",34663,19,5,26.3,96,28,16,57.1,0,-9,-11,-30.8,0.15625,0.417391304347826,-0.261141304347826
"704","phx",34679,20,7,35,114,19,5,26.3,0,1,2,8.7,0.184210526315789,0.120967741935484,0.0632427843803056
"705","phx",34693,29,12,41.4,105,27,10,37,1,2,2,4.4,0.342857142857143,0.29126213592233,0.0515950069348128
"706","phx",34701,28,11,39.3,112,17,7,41.2,0,11,4,-1.90000000000001,0.294642857142857,0.153284671532847,0.14135818561001
"707","phx",34714,27,5,18.5,106,26,9,34.6,0,1,-4,-16.1,0.141509433962264,0.243243243243243,-0.101733809280979
"708","phx",34728,23,5,21.7,91,24,14,58.3,0,-1,-9,-36.6,0.164835164835165,0.381818181818182,-0.216983016983017
"709","phx",34746,19,8,42.1,115,19,5,26.3,1,0,3,15.8,0.208695652173913,0.154639175257732,0.0540564769161811
"710","phx",34753,22,8,36.4,102,36,18,50,0,-14,-10,-13.6,0.235294117647059,0.406015037593985,-0.170720919946926
"711","phx",34769,23,8,34.8,108,28,8,28.6,0,-5,0,6.2,0.222222222222222,0.218181818181818,0.00404040404040404
"712","phx",34784,24,10,41.7,137,26,9,34.6,1,-2,1,7.1,0.218978102189781,0.267326732673267,-0.0483486304834863
"713","phx",34799,24,8,33.3,121,26,12,46.2,0,-2,-4,-12.9,0.198347107438017,0.28125,-0.0829028925619835
"714","phx",34815,14,5,35.7,96,20,6,30,0,-6,-1,5.7,0.15625,0.18,-0.02375
"715","phx",34832,21,7,33.3,112,25,12,48,0,-4,-5,-14.7,0.1875,0.276923076923077,-0.0894230769230769
"716","phx",34847,19,7,36.8,120,34,10,29.4,1,-15,-3,7.4,0.175,0.29126213592233,-0.11626213592233
"717","phx",34856,21,5,23.8,118,35,9,25.7,1,-14,-4,-1.9,0.127118644067797,0.243243243243243,-0.116124599175447
"718","phx",34869,20,4,20,109,37,13,35.1,1,-17,-9,-15.1,0.110091743119266,0.367924528301887,-0.257832785182621
"719","phx",34888,27,13,48.2,127,18,7,38.9,0,9,6,9.3,0.307086614173228,0.16030534351145,0.146781270661778
"720","phx",34903,19,6,31.6,110,27,12,44.4,0,-8,-6,-12.8,0.163636363636364,0.295081967213115,-0.131445603576751
"721","phx",34922,20,6,30,100,26,9,34.6,1,-6,-3,-4.6,0.18,0.275510204081633,-0.0955102040816326
"722","phx",34928,14,5,35.7,101,22,7,31.8,0,-8,-2,3.9,0.148514851485149,0.190909090909091,-0.0423942394239424
"723","phx",34952,25,6,24,101,14,6,42.9,0,11,0,-18.9,0.178217821782178,0.168224299065421,0.00999352271675766
"724","phx",34966,14,2,14.3,103,23,7,30.4,0,-9,-5,-16.1,0.058252427184466,0.192660550458716,-0.13440812327425
"725","phx",34978,22,6,27.3,95,25,12,48,0,-3,-6,-20.7,0.189473684210526,0.321428571428571,-0.131954887218045
"726","phx",34993,16,4,25,97,27,11,40.7,0,-11,-7,-15.7,0.123711340206186,0.294642857142857,-0.170931516936672
"727","phx",35007,25,7,28,98,29,8,27.6,0,-4,-1,0.399999999999999,0.214285714285714,0.19047619047619,0.0238095238095238
"728","phx",35016,19,6,31.6,120,41,14,34.2,0,-22,-8,-2.6,0.15,0.323076923076923,-0.173076923076923
"729","phx",35027,16,6,37.5,106,30,14,46.7,0,-14,-8,-9.2,0.169811320754717,0.35,-0.180188679245283
"730","phx",35046,31,7,22.6,91,27,6,22.2,0,4,1,0.400000000000002,0.230769230769231,0.189473684210526,0.0412955465587045
"731","phx",35064,23,7,30.4,118,22,12,54.6,0,1,-5,-24.2,0.177966101694915,0.290322580645161,-0.112356478950246
"732","phx",35081,10,3,30,117,37,15,40.5,0,-27,-12,-10.5,0.0769230769230769,0.346153846153846,-0.269230769230769
"733","phx",35093,34,8,23.5,116,38,14,36.8,0,-4,-6,-13.3,0.206896551724138,0.341463414634146,-0.134566862910008
"734","phx",35111,27,7,25.9,111,31,13,41.9,0,-4,-6,-16,0.189189189189189,0.325,-0.135810810810811
"735","phx",35126,18,8,44.4,120,31,7,22.6,1,-13,1,21.8,0.2,0.212121212121212,-0.0121212121212121
"736","phx",35139,19,8,42.1,124,45,16,35.6,1,-26,-8,6.5,0.193548387096774,0.432432432432432,-0.238884045335658
"737","phx",35156,30,8,26.7,104,19,9,47.4,0,11,-1,-20.7,0.230769230769231,0.209302325581395,0.0214669051878354
"738","phx",40235,27,10,37,92,16,5,31.2,0,11,5,5.8,0.326086956521739,0.14018691588785,0.185900040633889
"739","sac",33952,21,6,28.6,113,16,4,25,1,5,2,3.6,0.15929203539823,0.127659574468085,0.031632460930145
"740","sac",33956,20,6,30,94,18,6,33.3,0,2,0,-3.3,0.191489361702128,0.176470588235294,0.0150187734668335
"741","sac",33974,26,9,34.6,106,22,7,31.8,1,4,2,2.8,0.254716981132075,0.203883495145631,0.0508334859864444
"742","sac",33984,23,10,43.5,95,30,11,36.7,0,-7,-1,6.8,0.315789473684211,0.311320754716981,0.00446871896722939
"743","sac",33989,23,5,21.7,96,29,13,44.8,0,-6,-8,-23.1,0.15625,0.361111111111111,-0.204861111111111
"744","sac",34005,18,7,38.9,94,30,10,33.3,0,-12,-3,5.6,0.223404255319149,0.294117647058824,-0.0707133917396746
"745","sac",34025,28,10,35.7,91,33,14,42.4,0,-5,-4,-6.7,0.32967032967033,0.358974358974359,-0.0293040293040293
"746","sac",34029,16,5,31.2,96,30,7,23.3,1,-14,-2,7.9,0.15625,0.230769230769231,-0.0745192307692308
"747","sac",34045,25,8,32,102,21,5,23.8,1,4,3,8.2,0.235294117647059,0.159574468085106,0.0757196495619524
"748","sac",34060,21,8,38.1,91,27,9,33.3,0,-6,-1,4.8,0.263736263736264,0.267326732673267,-0.0035904689370036
"749","sac",34068,21,6,28.6,120,33,13,39.4,0,-12,-7,-10.8,0.15,0.319672131147541,-0.169672131147541
"750","sac",34108,20,9,45,105,30,11,36.7,0,-10,-2,8.3,0.257142857142857,0.3,-0.0428571428571429
"751","sac",34123,26,10,38.5,115,29,13,44.8,0,-3,-3,-6.3,0.260869565217391,0.322314049586777,-0.0614444843693855
"752","sac",34136,27,11,40.7,102,24,9,37.5,1,3,2,3.2,0.323529411764706,0.272727272727273,0.0508021390374332
"753","sac",34164,28,12,42.9,116,25,7,28,1,3,5,14.9,0.310344827586207,0.207920792079208,0.102424035506999
"754","sac",34179,32,9,28.1,104,50,21,42,0,-18,-12,-13.9,0.259615384615385,0.538461538461538,-0.278846153846154
"755","sac",34187,23,13,56.5,122,39,16,41,1,-16,-3,15.5,0.319672131147541,0.457142857142857,-0.137470725995316
"756","sac",34193,21,3,14.3,95,25,10,40,0,-4,-7,-25.7,0.0947368421052632,0.297029702970297,-0.202292860865034
"757","sac",34223,26,6,23.1,92,28,11,39.3,0,-2,-5,-16.2,0.195652173913043,0.34020618556701,-0.144554011653967
"758","sac",34242,28,9,32.1,98,29,11,37.9,0,-1,-2,-5.8,0.275510204081633,0.311320754716981,-0.0358105506353485
"759","sac",34268,22,10,45.4,120,30,10,33.3,1,-8,0,12.1,0.25,0.337078651685393,-0.0870786516853932
"760","sac",34285,28,7,25,100,29,10,34.5,0,-1,-3,-9.5,0.21,0.29126213592233,-0.0812621359223301
"761","sac",34294,26,9,34.6,84,29,13,44.8,0,-3,-4,-10.2,0.321428571428571,0.375,-0.0535714285714285
"762","sac",34307,23,10,43.5,116,23,10,43.5,1,0,0,0,0.258620689655172,0.326086956521739,-0.0674662668665667
"763","sac",34320,32,11,34.4,98,42,22,52.4,0,-10,-11,-18,0.336734693877551,0.5,-0.163265306122449
"764","sac",34334,24,7,29.2,96,25,5,20,1,-1,2,9.2,0.21875,0.16304347826087,0.0557065217391304
"765","sac",34351,31,8,25.8,79,33,13,39.4,0,-2,-5,-13.6,0.30379746835443,0.393939393939394,-0.0901419255849635
"766","sac",34368,23,10,43.5,126,28,4,14.3,1,-5,6,29.2,0.238095238095238,0.0991735537190083,0.13892168437623
"767","sac",34374,21,10,47.6,94,27,9,33.3,1,-6,1,14.3,0.319148936170213,0.290322580645161,0.0288263555250515
"768","sac",34390,29,15,51.7,109,32,12,37.5,1,-3,3,14.2,0.412844036697248,0.342857142857143,0.0699868938401049
"769","sac",34411,25,7,28,102,25,9,36,1,0,-2,-8,0.205882352941176,0.27,-0.0641176470588236
"770","sac",34424,28,9,32.1,89,25,12,48,0,3,-3,-15.9,0.303370786516854,0.352941176470588,-0.0495703899537343
"771","sac",34442,28,11,39.3,98,35,17,48.6,0,-7,-6,-9.3,0.336734693877551,0.455357142857143,-0.118622448979592
"772","sac",34466,29,11,37.9,120,38,18,47.4,1,-9,-7,-9.5,0.275,0.47787610619469,-0.20287610619469
"773","sac",34475,20,8,40,102,28,12,42.9,0,-8,-4,-2.9,0.235294117647059,0.336448598130841,-0.101154480483782
"774","sac",34491,30,9,30,98,31,13,41.9,0,-1,-4,-11.9,0.275510204081633,0.367924528301887,-0.0924143242202541
"775","sac",34506,28,11,39.3,106,29,10,34.5,0,-1,1,4.8,0.311320754716981,0.256410256410256,0.0549104983067247
"776","sac",34519,23,13,56.5,100,27,12,44.4,1,-4,1,12.1,0.39,0.382978723404255,0.0070212765957447
"777","sac",34539,25,9,36,108,37,15,40.5,0,-12,-6,-4.5,0.25,0.375,-0.125
"778","sac",34550,24,9,37.5,118,28,9,32.1,0,-4,0,5.4,0.228813559322034,0.221311475409836,0.00750208391219784
"779","sac",34575,21,9,42.9,100,21,7,33.3,0,0,2,9.6,0.27,0.19811320754717,0.0718867924528302
"780","sac",34584,29,6,20.7,91,28,11,39.3,0,1,-5,-18.6,0.197802197802198,0.308411214953271,-0.110609017151073
"781","sac",34600,26,9,34.6,99,17,6,35.3,0,9,3,-0.699999999999996,0.272727272727273,0.176470588235294,0.0962566844919786
"782","sac",34609,21,9,42.9,109,28,10,35.7,1,-7,-1,7.2,0.247706422018349,0.288461538461538,-0.0407551164431898
"783","sac",34620,31,11,35.5,116,38,15,39.5,1,-7,-4,-4,0.28448275862069,0.401785714285714,-0.117302955665025
"784","sac",34635,26,13,50,111,28,10,35.7,0,-2,3,14.3,0.351351351351351,0.260869565217391,0.0904817861339601
"785","sac",34644,27,11,40.7,109,37,12,32.4,1,-10,-1,8.3,0.302752293577982,0.339622641509434,-0.0368703479314523
"786","sac",34666,29,8,27.6,83,45,14,31.1,0,-16,-6,-3.5,0.289156626506024,0.4,-0.110843373493976
"787","sac",34693,27,10,37,103,29,12,41.4,0,-2,-2,-4.4,0.29126213592233,0.342857142857143,-0.0515950069348128
"788","sac",34704,23,7,30.4,109,44,15,34.1,1,-21,-8,-3.7,0.192660550458716,0.424528301886792,-0.231867751428077
"789","sac",34718,28,11,39.3,107,19,6,31.6,0,9,5,7.7,0.308411214953271,0.160714285714286,0.147696929238985
"790","sac",34733,25,10,40,108,32,10,31.2,1,-7,0,8.8,0.277777777777778,0.326086956521739,-0.0483091787439613
"791","sac",34747,36,18,50,108,30,11,36.7,1,6,7,13.3,0.5,0.308411214953271,0.191588785046729
"792","sac",34759,31,11,35.5,105,31,13,41.9,1,0,-2,-6.4,0.314285714285714,0.393939393939394,-0.0796536796536796
"793","sac",34773,24,7,29.2,97,29,12,41.4,1,-5,-5,-12.2,0.216494845360825,0.375,-0.158505154639175
"794","sac",34787,24,7,29.2,86,36,13,36.1,0,-12,-6,-6.9,0.244186046511628,0.357798165137615,-0.113612118625987
"795","sac",34795,14,7,50,116,35,12,34.3,1,-21,-5,15.7,0.181034482758621,0.36,-0.178965517241379
"796","sac",34806,28,11,39.3,85,38,14,36.8,0,-10,-3,2.5,0.388235294117647,0.424242424242424,-0.0360071301247772
"797","sac",34828,17,6,35.3,88,23,8,34.8,0,-6,-2,0.5,0.204545454545455,0.235294117647059,-0.0307486631016043
"798","sac",34845,22,11,50,100,28,11,39.3,0,-6,0,10.7,0.33,0.302752293577982,0.0272477064220183
"799","sac",34871,17,8,47.1,109,33,10,30.3,0,-16,-2,16.8,0.220183486238532,0.272727272727273,-0.0525437864887406
"800","sac",34883,16,6,37.5,96,30,13,43.3,0,-14,-7,-5.8,0.1875,0.361111111111111,-0.173611111111111
"801","sac",34897,19,7,36.8,104,29,14,48.3,0,-10,-7,-11.5,0.201923076923077,0.368421052631579,-0.166497975708502
"802","sac",34912,22,12,54.6,122,26,9,34.6,0,-4,3,20,0.295081967213115,0.207692307692308,0.087389659520807
"803","sac",34924,23,8,34.8,92,34,9,26.5,0,-11,-1,8.3,0.260869565217391,0.257142857142857,0.00372670807453418
"804","sac",34937,30,16,53.3,120,34,13,38.2,1,-4,3,15.1,0.4,0.339130434782609,0.0608695652173913
"805","sac",34952,14,6,42.9,107,25,6,24,1,-11,0,18.9,0.168224299065421,0.178217821782178,-0.00999352271675766
"806","sac",34968,21,5,23.8,94,26,10,38.5,0,-5,-5,-14.7,0.159574468085106,0.272727272727273,-0.113152804642166
"807","sac",34982,10,7,70,102,28,11,39.3,0,-18,-4,30.7,0.205882352941176,0.279661016949153,-0.0737786640079761
"808","sac",35005,26,10,38.5,98,35,16,45.7,0,-9,-6,-7.2,0.306122448979592,0.413793103448276,-0.107670654468684
"809","sac",35021,21,10,47.6,100,31,10,32.3,0,-10,0,15.3,0.3,0.263157894736842,0.0368421052631579
"810","sac",35029,28,13,46.4,98,29,10,34.5,1,-1,3,11.9,0.397959183673469,0.309278350515464,0.0886808331580055
"811","sac",35041,25,6,24,91,26,5,19.2,1,-1,1,4.8,0.197802197802198,0.166666666666667,0.0311355311355311
"812","sac",35060,15,2,13.3,82,32,13,40.6,0,-17,-11,-27.3,0.0731707317073171,0.348214285714286,-0.275043554006969
"813","sac",35072,19,6,31.6,89,33,10,30.3,0,-14,-4,1.3,0.202247191011236,0.256410256410256,-0.0541630653990204
"814","sac",35080,19,11,57.9,123,25,9,36,1,-6,2,21.9,0.268292682926829,0.230769230769231,0.0375234521575985
"815","sac",35103,22,12,54.6,98,43,12,27.9,1,-21,0,26.7,0.36734693877551,0.413793103448276,-0.0464461646727656
"816","sac",35127,20,8,40,94,24,4,16.7,0,-4,4,23.3,0.25531914893617,0.122448979591837,0.132870169344333
"817","sac",35140,31,9,29,128,43,18,41.9,0,-12,-9,-12.9,0.2109375,0.4,-0.1890625
"818","sac",35156,19,9,47.4,129,30,8,26.7,1,-11,1,20.7,0.209302325581395,0.230769230769231,-0.0214669051878354
"819","sac",35168,11,5,45.4,95,28,10,35.7,0,-17,-5,9.7,0.157894736842105,0.260869565217391,-0.102974828375286
"820","sac",40227,29,13,44.8,119,31,11,35.5,0,-2,2,9.3,0.327731092436975,0.270491803278689,0.0572392891582862
"821","chi",33955,25,11,44,105,23,8,34.8,1,2,3,9.2,0.314285714285714,0.242424242424242,0.0718614718614718
"822","chi",33970,21,9,42.9,118,18,7,38.9,1,3,2,4,0.228813559322034,0.207920792079208,0.020892767242826
"823","chi",33983,27,11,40.7,118,31,5,16.1,1,-4,6,24.6,0.279661016949153,0.170454545454545,0.109206471494607
"824","chi",34001,20,7,35,100,32,14,43.8,0,-12,-7,-8.8,0.21,0.392523364485981,-0.182523364485981
"825","chi",34013,23,8,34.8,104,21,9,42.9,0,2,-1,-8.1,0.230769230769231,0.230769230769231,0
"826","chi",34023,18,6,33.3,94,26,12,46.2,0,-8,-6,-12.9,0.191489361702128,0.324324324324324,-0.132834962622197
"827","chi",34036,19,3,15.8,112,30,9,30,1,-11,-6,-14.2,0.0803571428571429,0.3375,-0.257142857142857
"828","chi",34051,27,9,33.3,107,20,9,45,0,7,0,-11.7,0.252336448598131,0.234782608695652,0.0175538399024786
"829","chi",34058,16,6,37.5,98,29,13,44.8,1,-13,-7,-7.3,0.183673469387755,0.410526315789474,-0.226852846401719
"830","chi",34073,15,5,33.3,106,13,4,30.8,1,2,1,2.5,0.141509433962264,0.126315789473684,0.0151936444885799
"831","chi",34096,20,7,35,113,34,9,26.5,1,-14,-2,8.5,0.185840707964602,0.306818181818182,-0.12097747385358
"832","chi",34113,17,5,29.4,85,25,5,20,1,-8,0,9.4,0.176470588235294,0.194805194805195,-0.0183346065699007
"833","chi",34132,30,9,30,95,27,11,40.7,0,3,-2,-10.7,0.284210526315789,0.323529411764706,-0.0393188854489164
"834","chi",34138,22,8,36.4,118,31,13,41.9,1,-9,-5,-5.5,0.203389830508475,0.354545454545455,-0.15115562403698
"835","chi",34150,18,6,33.3,107,22,10,45.4,0,-4,-4,-12.1,0.168224299065421,0.272727272727273,-0.104502973661852
"836","chi",34169,21,6,28.6,105,22,9,40.9,1,-1,-3,-12.3,0.171428571428571,0.303370786516854,-0.131942215088283
"837","chi",34209,21,4,19,90,8,2,25,0,13,2,-6,0.133333333333333,0.0625,0.0708333333333333
"838","chi",34226,18,3,16.7,111,26,10,38.5,1,-8,-7,-21.8,0.0810810810810811,0.285714285714286,-0.204633204633205
"839","chi",34236,13,3,23.1,82,31,13,41.9,0,-18,-10,-18.8,0.109756097560976,0.364485981308411,-0.254729883747436
"840","chi",34248,23,7,30.4,110,24,9,37.5,0,-1,-2,-7.1,0.190909090909091,0.241071428571429,-0.0501623376623377
"841","chi",34257,15,2,13.3,91,21,8,38.1,0,-6,-6,-24.8,0.0659340659340659,0.235294117647059,-0.169360051712993
"842","chi",34276,17,4,23.5,95,28,9,32.1,1,-11,-5,-8.6,0.126315789473684,0.296703296703297,-0.170387507229612
"843","chi",34290,8,1,12.5,105,20,5,25,1,-12,-4,-12.5,0.0285714285714286,0.15,-0.121428571428571
"844","chi",34310,15,4,26.7,94,21,6,28.6,0,-6,-2,-1.9,0.127659574468085,0.181818181818182,-0.0541586073500967
"845","chi",34324,20,5,25,97,20,11,55,0,0,-6,-30,0.154639175257732,0.305555555555556,-0.150916380297824
"846","chi",34333,21,5,23.8,69,25,10,40,0,-4,-5,-16.2,0.217391304347826,0.315789473684211,-0.0983981693363844
"847","chi",34354,16,8,50,113,23,3,13,1,-7,5,37,0.212389380530973,0.109756097560976,0.102633282969998
"848","chi",34372,21,6,28.6,97,18,3,16.7,0,3,3,11.9,0.185567010309278,0.0841121495327103,0.101454860776568
"849","chi",34382,22,7,31.8,91,18,5,27.8,0,4,2,4,0.230769230769231,0.145631067961165,0.0851381628080657
"850","chi",34398,18,7,38.9,100,18,9,50,0,0,-2,-11.1,0.21,0.226890756302521,-0.016890756302521
"851","chi",34405,25,6,24,90,25,9,36,1,0,-3,-12,0.2,0.317647058823529,-0.117647058823529
"852","chi",34420,13,3,23.1,101,32,13,40.6,1,-19,-10,-17.5,0.0891089108910891,0.393939393939394,-0.304830483048305
"853","chi",34432,23,6,26.1,101,19,7,36.8,0,4,-1,-10.7,0.178217821782178,0.189189189189189,-0.010971367407011
"854","chi",34443,27,10,37,96,15,9,60,0,12,1,-23,0.3125,0.232758620689655,0.0797413793103448
"855","chi",34457,23,7,30.4,118,19,9,47.4,1,4,-2,-17,0.177966101694915,0.243243243243243,-0.065277141548328
"856","chi",34472,30,13,43.3,106,25,8,32,1,5,5,11.3,0.367924528301887,0.25531914893617,0.112605379365717
"857","chi",34494,28,11,39.3,123,31,8,25.8,1,-3,3,13.5,0.268292682926829,0.203389830508475,0.0649028524183547
"858","chi",34509,19,7,36.8,94,24,7,29.2,0,-5,0,7.6,0.223404255319149,0.192660550458716,0.0307437048604333
"859","chi",34511,27,10,37,99,22,11,50,0,5,-1,-13,0.303030303030303,0.326732673267327,-0.0237023702370237
"860","chi",34528,18,3,16.7,89,23,7,30.4,0,-5,-4,-13.7,0.101123595505618,0.201923076923077,-0.100799481417459
"861","chi",34542,20,8,40,107,23,7,30.4,1,-3,1,9.6,0.224299065420561,0.212121212121212,0.0121778532993486
"862","chi",34551,17,4,23.5,108,32,11,34.4,1,-15,-7,-10.9,0.111111111111111,0.317307692307692,-0.206196581196581
"863","chi",34564,14,6,42.9,98,28,11,39.3,0,-14,-5,3.6,0.183673469387755,0.333333333333333,-0.149659863945578
"864","chi",34587,28,7,25,93,22,9,40.9,0,6,-2,-15.9,0.225806451612903,0.264705882352941,-0.038899430740038
"865","chi",34600,17,6,35.3,102,26,9,34.6,1,-9,-3,0.699999999999996,0.176470588235294,0.272727272727273,-0.0962566844919786
"866","chi",34617,22,7,31.8,100,22,7,31.8,1,0,0,0,0.21,0.228260869565217,-0.0182608695652174
"867","chi",34623,27,8,29.6,114,30,17,56.7,0,-3,-9,-27.1,0.210526315789474,0.428571428571429,-0.218045112781955
"868","chi",34640,13,3,23.1,88,24,9,37.5,0,-11,-6,-14.4,0.102272727272727,0.27,-0.167727272727273
"869","chi",34656,14,8,57.1,121,28,10,35.7,1,-14,-2,21.4,0.198347107438017,0.277777777777778,-0.0794306703397613
"870","chi",34680,15,6,40,128,37,10,27,1,-22,-4,13,0.140625,0.3,-0.159375
"871","chi",34689,25,8,32,117,43,16,37.2,0,-18,-8,-5.2,0.205128205128205,0.396694214876033,-0.191566009747828
"872","chi",34718,19,6,31.6,112,28,11,39.3,1,-9,-5,-7.7,0.160714285714286,0.308411214953271,-0.147696929238985
"873","chi",34732,24,4,16.7,92,28,15,53.6,0,-4,-11,-36.9,0.130434782608696,0.365853658536585,-0.23541887592789
"874","chi",34746,19,5,26.3,97,19,8,42.1,0,0,-3,-15.8,0.154639175257732,0.208695652173913,-0.0540564769161811
"875","chi",34756,25,10,40,89,24,6,25,0,1,4,15,0.337078651685393,0.153846153846154,0.183232497839239
"876","chi",34771,17,7,41.2,105,20,5,25,1,-3,2,16.2,0.2,0.159574468085106,0.0404255319148936
"877","chi",34789,25,6,24,104,37,14,37.8,1,-12,-8,-13.8,0.173076923076923,0.407766990291262,-0.234690067214339
"878","chi",34799,26,12,46.2,128,24,8,33.3,1,2,4,12.9,0.28125,0.198347107438017,0.0829028925619835
"879","chi",34811,30,15,50,117,37,14,37.8,1,-7,1,12.2,0.384615384615385,0.424242424242424,-0.0396270396270396
"880","chi",34831,26,10,38.5,107,30,13,43.3,0,-4,-3,-4.8,0.280373831775701,0.312,-0.0316261682242991
"881","chi",34846,19,5,26.3,94,30,6,20,1,-11,-1,6.3,0.159574468085106,0.206896551724138,-0.0473220836390315
"882","chi",34862,17,6,35.3,91,25,6,24,0,-8,0,11.3,0.197802197802198,0.178217821782178,0.0195843760200196
"883","chi",34878,28,8,28.6,95,21,6,28.6,0,7,2,0,0.252631578947368,0.165137614678899,0.0874939642684693
"884","chi",34889,28,12,42.9,91,25,7,28,0,3,5,14.9,0.395604395604396,0.214285714285714,0.181318681318681
"885","chi",34906,39,9,23.1,94,47,15,31.9,0,-8,-6,-8.8,0.287234042553192,0.391304347826087,-0.104070305272895
"886","chi",34925,25,7,28,80,37,16,43.2,0,-12,-9,-15.2,0.2625,0.48,-0.2175
"887","chi",34931,40,14,35,115,29,7,24.1,1,11,7,10.9,0.365217391304348,0.192660550458716,0.172556840845632
"888","chi",34949,28,11,39.3,91,31,11,35.5,0,-3,0,3.8,0.362637362637363,0.336734693877551,0.0259026687598116
"889","chi",34961,27,7,25.9,107,26,10,38.5,0,1,-3,-12.6,0.196261682242991,0.267857142857143,-0.0715954606141522
"890","chi",34972,19,7,36.8,95,25,7,28,1,-6,0,8.8,0.221052631578947,0.244186046511628,-0.0231334149326805
"891","chi",34991,37,14,37.8,120,23,8,34.8,0,14,6,3,0.35,0.19672131147541,0.15327868852459
"892","chi",35001,23,11,47.8,117,20,7,35,1,3,4,12.8,0.282051282051282,0.221052631578947,0.0609986504723347
"893","chi",35017,24,10,41.7,107,25,8,32,0,-1,2,9.7,0.280373831775701,0.205128205128205,0.0752456266474958
"894","chi",35030,21,10,47.6,109,23,7,30.4,1,-2,3,17.2,0.275229357798165,0.223404255319149,0.0518251024790162
"895","chi",35062,25,12,48,99,27,10,37,1,-2,2,11,0.363636363636364,0.32258064516129,0.0410557184750733
"896","chi",35078,30,12,40,106,28,11,39.3,1,2,1,0.700000000000003,0.339622641509434,0.317307692307692,0.0223149492017417
"897","chi",35087,26,13,50,117,30,10,33.3,1,-4,3,16.7,0.333333333333333,0.272727272727273,0.0606060606060606
"898","chi",35100,27,6,22.2,91,23,6,26.1,0,4,0,-3.9,0.197802197802198,0.18,0.0178021978021978
"899","chi",35113,25,8,32,102,33,7,21.2,1,-8,1,10.8,0.235294117647059,0.233333333333333,0.00196078431372548
"900","chi",35128,24,11,45.8,106,31,10,32.3,0,-7,1,13.5,0.311320754716981,0.280373831775701,0.0309469229412802
"901","chi",35146,26,12,46.2,122,27,5,18.5,1,-1,7,27.7,0.295081967213115,0.2,0.0950819672131147
"902","chi",35162,30,14,46.7,112,33,3,9.1,1,-3,11,37.6,0.375,0.123287671232877,0.251712328767123
"903","cle",33941,35,13,37.1,117,27,9,33.3,1,8,4,3.8,0.333333333333333,0.306818181818182,0.0265151515151515
"904","cle",33958,32,12,37.5,94,16,4,25,1,16,8,12.5,0.382978723404255,0.131868131868132,0.251110591536123
"905","cle",33969,37,11,29.7,105,28,8,28.6,1,9,3,1.1,0.314285714285714,0.242424242424242,0.0718614718614718
"906","cle",33987,32,16,50,128,44,17,38.6,1,-12,-1,11.4,0.375,0.425,-0.05
"907","cle",34008,34,14,41.2,128,32,11,34.4,1,2,3,6.8,0.328125,0.270491803278689,0.0576331967213115
"908","cle",34020,38,14,36.8,102,38,14,36.8,1,0,0,0,0.411764705882353,0.415841584158416,-0.0040768782760629
"909","cle",34040,42,11,26.2,106,29,11,37.9,0,13,0,-11.7,0.311320754716981,0.3,0.0113207547169811
"910","cle",34062,33,14,42.4,105,15,3,20,1,18,11,22.4,0.4,0.0957446808510638,0.304255319148936
"911","cle",34080,38,14,36.8,100,29,11,37.9,1,9,3,-1.1,0.42,0.354838709677419,0.0651612903225806
"912","cle",34093,33,13,39.4,121,29,13,44.8,1,4,0,-5.4,0.322314049586777,0.333333333333333,-0.0110192837465565
"913","cle",34100,30,11,36.7,93,28,10,35.7,0,2,1,1,0.354838709677419,0.29126213592233,0.0635765737550893
"914","cle",34116,25,11,44,104,19,6,31.6,1,6,5,12.4,0.317307692307692,0.222222222222222,0.0950854700854701
"915","cle",34155,36,21,58.3,137,29,13,44.8,1,7,8,13.5,0.45985401459854,0.312,0.14785401459854
"916","cle",34167,43,20,46.5,128,35,8,22.9,1,8,12,23.6,0.46875,0.266666666666667,0.202083333333333
"917","cle",34185,40,12,30,112,34,15,44.1,1,6,-3,-14.1,0.321428571428571,0.416666666666667,-0.0952380952380952
"918","cle",34202,39,14,35.9,101,19,7,36.8,0,20,7,-0.899999999999999,0.415841584158416,0.177966101694915,0.237875482463501
"919","cle",34219,24,9,37.5,94,31,13,41.9,0,-7,-4,-4.4,0.287234042553192,0.345132743362832,-0.0578987008096403
"920","cle",34226,26,10,38.5,105,18,3,16.7,0,8,7,21.8,0.285714285714286,0.0810810810810811,0.204633204633205
"921","cle",34245,32,14,43.8,116,32,13,40.6,1,0,1,3.2,0.362068965517241,0.348214285714286,0.0138546798029557
"922","cle",34267,40,22,55,126,31,11,35.5,1,9,11,19.5,0.523809523809524,0.351063829787234,0.17274569402229
"923","cle",34278,24,9,37.5,114,27,6,22.2,1,-3,3,15.3,0.236842105263158,0.214285714285714,0.0225563909774436
"924","cle",34289,31,13,41.9,116,27,10,37,1,4,3,4.9,0.336206896551724,0.285714285714286,0.0504926108374384
"925","cle",34308,31,12,38.7,103,22,4,18.2,1,9,8,20.5,0.349514563106796,0.13953488372093,0.209979679385866
"926","cle",34319,25,9,36,85,23,12,52.2,0,2,-3,-16.2,0.317647058823529,0.387096774193548,-0.069449715370019
"927","cle",34342,33,15,45.4,119,37,16,43.2,1,-4,-1,2.2,0.378151260504202,0.444444444444444,-0.0662931839402428
"928","cle",34363,40,17,42.5,114,27,7,25.9,1,13,10,16.6,0.447368421052632,0.194444444444444,0.252923976608187
"929","cle",34369,27,15,55.6,113,22,9,40.9,1,5,6,14.7,0.398230088495575,0.264705882352941,0.133524206142634
"930","cle",34384,35,8,22.9,119,30,8,26.7,1,5,0,-3.8,0.201680672268908,0.242424242424242,-0.0407435701553349
"931","cle",34397,35,12,34.3,109,30,9,30,1,5,3,4.3,0.330275229357798,0.25,0.0802752293577982
"932","cle",34404,28,11,39.3,90,28,16,57.1,0,0,-5,-17.8,0.366666666666667,0.452830188679245,-0.0861635220125787
"933","cle",34428,38,14,36.8,124,37,12,32.4,1,1,2,4.4,0.338709677419355,0.305084745762712,0.0336249316566429
"934","cle",34444,31,14,45.2,121,24,9,37.5,1,7,5,7.7,0.347107438016529,0.247706422018349,0.0994010159981803
"935","cle",34454,31,6,19.4,90,26,11,42.3,1,5,-5,-22.9,0.2,0.402439024390244,-0.202439024390244
"936","cle",34472,25,8,32,94,30,13,43.3,0,-5,-5,-11.3,0.25531914893617,0.367924528301887,-0.112605379365717
"937","cle",34487,33,9,27.3,116,30,9,30,1,3,0,-2.7,0.232758620689655,0.25,-0.0172413793103448
"938","cle",34505,34,15,44.1,120,27,9,33.3,1,7,6,10.8,0.375,0.232758620689655,0.142241379310345
"939","cle",34516,31,9,29,92,34,13,38.2,0,-3,-4,-9.2,0.293478260869565,0.39,-0.0965217391304348
"940","cle",34525,30,9,30,86,30,10,33.3,0,0,-1,-3.3,0.313953488372093,0.294117647058824,0.0198358413132695
"941","cle",34539,37,15,40.5,120,25,9,36,1,12,6,4.5,0.375,0.25,0.125
"942","cle",34559,34,9,26.5,91,34,15,44.1,0,0,-6,-17.6,0.296703296703297,0.357142857142857,-0.0604395604395604
"943","cle",34576,43,19,44.2,118,19,4,21,1,24,15,23.2,0.483050847457627,0.116504854368932,0.366545993088695
"944","cle",34597,34,13,38.2,115,26,10,38.5,0,8,3,-0.299999999999997,0.339130434782609,0.254237288135593,0.0848931466470155
"945","cle",34611,37,15,40.5,122,39,16,41,0,-2,-1,-0.5,0.368852459016393,0.387096774193548,-0.0182443151771549
"946","cle",34620,38,15,39.5,112,31,11,35.5,0,7,4,4,0.401785714285714,0.28448275862069,0.117302955665025
"947","cle",34636,36,13,36.1,124,33,16,48.5,1,3,-3,-12.4,0.314516129032258,0.413793103448276,-0.0992769744160178
"948","cle",34652,29,8,27.6,107,26,6,23.1,1,3,2,4.5,0.224299065420561,0.197802197802198,0.026496867618363
"949","cle",34662,32,12,37.5,97,32,9,28.1,0,0,3,9.4,0.371134020618557,0.259615384615385,0.111518636003172
"950","cle",34671,37,15,40.5,125,21,7,33.3,1,16,8,7.2,0.36,0.216494845360825,0.143505154639175
"951","cle",34699,40,16,40,111,31,12,38.7,1,9,4,1.3,0.432432432432432,0.346153846153846,0.0862785862785863
"952","cle",34709,38,19,50,140,29,12,41.4,1,9,7,8.6,0.407142857142857,0.266666666666667,0.14047619047619
"953","cle",34723,36,16,44.4,132,25,13,52,1,11,3,-7.6,0.363636363636364,0.333333333333333,0.0303030303030303
"954","cle",34736,21,10,47.6,109,27,8,29.6,0,-6,2,18,0.275229357798165,0.203389830508475,0.0718395272896906
"955","cle",34751,30,15,50,125,37,12,32.4,1,-7,3,17.6,0.36,0.330275229357798,0.0297247706422018
"956","cle",34772,39,13,33.3,116,23,9,39.1,1,16,4,-5.8,0.336206896551724,0.25,0.0862068965517241
"957","cle",34775,39,18,46.2,113,24,12,50,1,15,6,-3.8,0.47787610619469,0.346153846153846,0.131722260040844
"958","cle",34793,38,15,39.5,119,26,8,30.8,1,12,7,8.7,0.378151260504202,0.230769230769231,0.147382029734971
"959","cle",34811,37,14,37.8,99,30,15,50,0,7,-1,-12.2,0.424242424242424,0.384615384615385,0.0396270396270396
"960","cle",34824,27,10,37,102,29,11,37.9,1,-2,-1,-0.899999999999999,0.294117647058824,0.347368421052632,-0.0532507739938081
"961","cle",34839,33,10,30.3,99,31,13,41.9,0,2,-3,-11.6,0.303030303030303,0.378640776699029,-0.0756104736687261
"962","cle",34853,46,25,54.4,135,26,10,38.5,1,20,15,15.9,0.555555555555556,0.230769230769231,0.324786324786325
"963","cle",34861,27,11,40.7,92,34,18,52.9,0,-7,-7,-12.2,0.358695652173913,0.45,-0.091304347826087
"964","cle",34876,27,9,33.3,98,35,16,45.7,0,-8,-7,-12.4,0.275510204081633,0.452830188679245,-0.177319984597613
"965","cle",34900,39,11,28.2,101,26,9,34.6,0,13,2,-6.4,0.326732673267327,0.254716981132075,0.0720156921352513
"966","cle",34917,39,15,38.5,116,21,4,19,1,18,11,19.5,0.387931034482759,0.115384615384615,0.272546419098143
"967","cle",34929,43,17,39.5,112,45,16,35.6,0,-2,1,3.9,0.455357142857143,0.41025641025641,0.0451007326007326
"968","cle",34939,30,19,63.3,128,19,4,21,1,11,15,42.3,0.4453125,0.125,0.3203125
"969","cle",34954,33,9,27.3,91,21,5,23.8,1,12,4,3.5,0.296703296703297,0.180722891566265,0.115980405137032
"970","cle",34971,27,5,18.5,78,26,8,30.8,0,1,-3,-12.3,0.192307692307692,0.222222222222222,-0.0299145299145299
"971","cle",34983,36,13,36.1,125,27,11,40.7,1,9,2,-4.6,0.312,0.275,0.037
"972","cle",35004,37,15,40.5,113,26,11,42.3,0,11,4,-1.8,0.398230088495575,0.261904761904762,0.136325326590813
"973","cle",35013,25,9,36,112,38,10,26.3,1,-13,-1,9.7,0.241071428571429,0.285714285714286,-0.0446428571428571
"974","cle",35023,33,12,36.4,115,18,8,44.4,0,15,4,-8,0.31304347826087,0.188976377952756,0.124067100308114
"975","cle",35039,26,4,15.4,74,26,7,26.9,0,0,-3,-11.5,0.162162162162162,0.203883495145631,-0.0417213329834689
"976","cle",35062,27,10,37,93,25,12,48,0,2,-2,-11,0.32258064516129,0.363636363636364,-0.0410557184750733
"977","cle",35068,29,13,44.8,122,33,11,33.3,1,-4,2,11.5,0.319672131147541,0.314285714285714,0.00538641686182673
"978","cle",35091,43,18,41.9,135,41,16,39,1,2,2,2.9,0.4,0.369230769230769,0.0307692307692308
"979","cle",35096,36,18,50,122,33,11,33.3,1,3,7,16.7,0.442622950819672,0.323529411764706,0.119093539054966
"980","cle",35109,36,11,30.6,114,33,7,21.2,1,3,4,9.4,0.289473684210526,0.230769230769231,0.0587044534412955
"981","cle",35119,36,9,25,100,37,16,43.2,0,-1,-7,-18.2,0.27,0.421052631578947,-0.151052631578947
"982","cle",35137,46,19,41.3,125,31,9,29,0,15,10,12.3,0.456,0.214285714285714,0.241714285714286
"983","cle",35145,35,14,40,121,33,12,36.4,0,2,2,3.6,0.347107438016529,0.290322580645161,0.0567848573713676
"984","cle",35158,37,10,27,83,26,8,30.8,0,11,2,-3.8,0.36144578313253,0.244897959183673,0.116547823948857
"985","det",33947,22,4,18.2,91,18,3,16.7,0,4,1,1.5,0.131868131868132,0.0825688073394495,0.0492993245286823
"986","det",33960,19,7,36.8,108,26,8,30.8,1,-7,-1,6,0.194444444444444,0.292682926829268,-0.0982384823848238
"987","det",33978,20,5,25,98,17,4,23.5,1,3,1,1.5,0.153061224489796,0.144578313253012,0.00848291123678388
"988","det",33990,13,8,61.5,102,22,7,31.8,1,-9,1,29.7,0.235294117647059,0.235955056179775,-0.000660938532716454
"989","det",33997,25,9,36,101,27,13,48.2,0,-2,-4,-12.2,0.267326732673267,0.357798165137615,-0.0904714324643474
"990","det",34022,20,7,35,103,25,7,28,1,-5,0,7,0.203883495145631,0.244186046511628,-0.0403025513659968
"991","det",34038,12,4,33.3,82,25,13,52,0,-13,-9,-18.7,0.146341463414634,0.342105263157895,-0.195763799743261
"992","det",34053,22,9,40.9,100,22,8,36.4,0,0,1,4.5,0.27,0.224299065420561,0.0457009345794393
"993","det",34067,25,5,20,86,20,9,45,0,5,-4,-25,0.174418604651163,0.28125,-0.106831395348837
"994","det",34078,18,4,22.2,106,25,9,36,1,-7,-5,-13.8,0.113207547169811,0.284210526315789,-0.171002979145978
"995","det",34087,16,5,31.2,104,27,5,18.5,1,-11,0,12.7,0.144230769230769,0.170454545454545,-0.0262237762237762
"996","det",34102,23,8,34.8,102,25,9,36,0,-2,-1,-1.2,0.235294117647059,0.257142857142857,-0.0218487394957983
"997","det",34116,19,6,31.6,81,25,11,44,0,-6,-5,-12.4,0.222222222222222,0.317307692307692,-0.0950854700854701
"998","det",34128,20,7,35,92,31,12,38.7,0,-11,-5,-3.7,0.228260869565217,0.382978723404255,-0.154717853839038
"999","det",34143,17,7,41.2,96,31,10,32.3,0,-14,-3,8.90000000000001,0.21875,0.303030303030303,-0.084280303030303
"1000","det",34158,19,6,31.6,107,26,7,26.9,1,-7,-1,4.7,0.168224299065421,0.25,-0.0817757009345794
"1001","det",34170,19,9,47.4,108,21,7,33.3,1,-2,2,14.1,0.25,0.216494845360825,0.0335051546391752
"1002","det",34182,19,1,5.3,88,23,8,34.8,0,-4,-7,-29.5,0.0340909090909091,0.226415094339623,-0.192324185248714
"1003","det",34200,28,12,42.9,112,27,9,33.3,1,1,3,9.6,0.321428571428571,0.303370786516854,0.0180577849117175
"1004","det",34207,20,9,45,121,42,15,35.7,1,-22,-6,9.3,0.223140495867769,0.394736842105263,-0.171596346237495
"1005","det",34228,29,17,58.6,121,24,6,25,1,5,11,33.6,0.421487603305785,0.211764705882353,0.209722897423432
"1006","det",34240,27,10,37,92,23,7,30.4,0,4,3,6.6,0.326086956521739,0.214285714285714,0.111801242236025
"1007","det",34257,21,8,38.1,102,15,2,13.3,1,6,6,24.8,0.235294117647059,0.0659340659340659,0.169360051712993
"1008","det",34261,27,4,14.8,77,21,6,28.6,0,6,-2,-13.8,0.155844155844156,0.206896551724138,-0.0510523958799821
"1009","det",34282,29,14,48.3,117,16,3,18.8,1,13,11,29.5,0.358974358974359,0.1,0.258974358974359
"1010","det",34296,19,5,26.3,79,17,7,41.2,0,2,-2,-14.9,0.189873417721519,0.216494845360825,-0.0266214276393058
"1011","det",34321,17,5,29.4,95,25,8,32,1,-8,-3,-2.6,0.157894736842105,0.282352941176471,-0.124458204334365
"1012","det",34329,28,10,35.7,108,25,12,48,0,3,-2,-12.3,0.277777777777778,0.295081967213115,-0.017304189435337
"1013","det",34340,30,10,33.3,90,19,6,31.6,0,11,4,1.7,0.333333333333333,0.171428571428571,0.161904761904762
"1014","det",34354,23,3,13,82,16,8,50,0,7,-5,-37,0.109756097560976,0.212389380530973,-0.102633282969998
"1015","det",34371,23,6,26.1,86,30,12,40,0,-7,-6,-13.9,0.209302325581395,0.36734693877551,-0.158044613194115
"1016","det",34386,29,10,34.5,113,27,11,40.7,0,2,-1,-6.2,0.265486725663717,0.277310924369748,-0.0118241987060311
"1017","det",34404,28,16,57.1,106,28,11,39.3,1,0,5,17.8,0.452830188679245,0.366666666666667,0.0861635220125787
"1018","det",34419,24,6,25,94,22,11,50,0,2,-5,-25,0.191489361702128,0.277310924369748,-0.0858215626676203
"1019","det",34438,31,9,29,98,26,8,30.8,0,5,1,-1.8,0.275510204081633,0.228571428571429,0.0469387755102041
"1020","det",34449,22,9,40.9,107,26,14,53.8,1,-4,-5,-12.9,0.252336448598131,0.428571428571429,-0.176234979973298
"1021","det",34463,29,10,34.5,116,16,9,56.2,0,13,1,-21.7,0.258620689655172,0.223140495867769,0.0354801937874038
"1022","det",34478,28,10,35.7,115,26,10,38.5,1,2,0,-2.8,0.260869565217391,0.263157894736842,-0.00228832951945079
"1023","det",34499,25,8,32,125,35,15,42.9,1,-10,-7,-10.9,0.192,0.362903225806452,-0.170903225806452
"1024","det",34519,27,12,44.4,94,23,13,56.5,0,4,-1,-12.1,0.382978723404255,0.39,-0.0070212765957447
"1025","det",34531,28,6,21.4,107,29,15,51.7,0,-1,-9,-30.3,0.168224299065421,0.354330708661417,-0.186106409595997
"1026","det",34540,17,6,35.3,77,31,16,51.6,0,-14,-10,-16.3,0.233766233766234,0.436363636363636,-0.202597402597403
"1027","det",34552,25,9,36,102,26,6,23.1,1,-1,3,12.9,0.264705882352941,0.185567010309278,0.0791388720436628
"1028","det",34573,25,10,40,118,25,6,24,1,0,4,16,0.254237288135593,0.189473684210526,0.0647636039250669
"1029","det",34591,28,11,39.3,113,26,8,30.8,1,2,3,8.5,0.292035398230089,0.214285714285714,0.0777496839443742
"1030","det",34609,28,10,35.7,104,21,9,42.9,0,7,1,-7.2,0.288461538461538,0.247706422018349,0.0407551164431898
"1031","det",34645,12,4,33.3,103,28,14,50,0,-16,-10,-16.7,0.116504854368932,0.362068965517241,-0.245564111148309
"1032","det",34661,27,3,11.1,109,32,13,40.6,0,-5,-10,-29.5,0.0825688073394495,0.345132743362832,-0.262563936023382
"1033","det",34675,26,10,38.5,118,21,5,23.8,1,5,5,14.7,0.254237288135593,0.153061224489796,0.101176063645797
"1034","det",34688,26,11,42.3,116,17,5,29.4,1,9,6,12.9,0.28448275862069,0.138888888888889,0.145593869731801
"1035","det",34697,17,6,35.3,84,24,7,29.2,0,-7,-1,6.1,0.214285714285714,0.2,0.0142857142857143
"1036","det",34713,22,5,22.7,113,28,5,17.9,1,-6,0,4.8,0.132743362831858,0.15625,-0.0235066371681416
"1037","det",34726,16,4,25,121,23,6,26.1,1,-7,-2,-1.1,0.0991735537190083,0.176470588235294,-0.0772970345162859
"1038","det",34741,17,5,29.4,92,19,9,47.4,0,-2,-4,-18,0.16304347826087,0.262135922330097,-0.0990924440692275
"1039","det",34758,31,8,25.8,102,16,8,50,1,15,0,-24.2,0.235294117647059,0.237623762376238,-0.00232964472917879
"1040","det",34764,21,7,33.3,89,21,6,28.6,0,0,1,4.7,0.235955056179775,0.176470588235294,0.0594844679444811
"1041","det",34779,20,6,30,98,36,10,27.8,1,-16,-4,2.2,0.183673469387755,0.32967032967033,-0.145996860282575
"1042","det",34791,37,15,40.5,114,30,7,23.3,1,7,8,17.2,0.394736842105263,0.194444444444444,0.200292397660819
"1043","det",34819,33,12,36.4,98,35,12,34.3,0,-2,0,2.1,0.36734693877551,0.346153846153846,0.0211930926216641
"1044","det",34830,25,7,28,120,25,10,40,1,0,-3,-12,0.175,0.265486725663717,-0.0904867256637168
"1045","det",34841,23,3,13,86,25,9,36,0,-2,-6,-23,0.104651162790698,0.247706422018349,-0.143055259227651
"1046","det",34859,23,10,43.5,136,34,14,41.2,1,-11,-4,2.3,0.220588235294118,0.39622641509434,-0.175638179800222
"1047","det",34878,21,6,28.6,109,28,8,28.6,1,-7,-2,0,0.165137614678899,0.252631578947368,-0.0874939642684693
"1048","det",34896,26,7,26.9,98,23,11,47.8,0,3,-4,-20.9,0.214285714285714,0.28695652173913,-0.0726708074534162
"1049","det",34900,26,9,34.6,106,39,11,28.2,1,-13,-2,6.4,0.254716981132075,0.326732673267327,-0.0720156921352513
"1050","det",34915,27,9,33.3,112,30,13,43.3,1,-3,-4,-10,0.241071428571429,0.423913043478261,-0.182841614906832
"1051","det",34939,19,4,21,96,30,19,63.3,0,-11,-15,-42.3,0.125,0.4453125,-0.3203125
"1052","det",34948,13,3,23.1,83,28,13,46.4,0,-15,-10,-23.3,0.108433734939759,0.402061855670103,-0.293628120730344
"1053","det",34963,20,3,15,75,27,9,33.3,0,-7,-6,-18.3,0.12,0.310344827586207,-0.190344827586207
"1054","det",34978,25,12,48,112,22,6,27.3,1,3,6,20.7,0.321428571428571,0.189473684210526,0.131954887218045
"1055","det",34992,23,5,21.7,96,29,10,34.5,0,-6,-5,-12.8,0.15625,0.306122448979592,-0.149872448979592
"1056","det",35001,20,7,35,95,23,11,47.8,0,-3,-4,-12.8,0.221052631578947,0.282051282051282,-0.0609986504723347
"1057","det",35014,22,2,9.1,87,26,12,46.2,0,-4,-10,-37.1,0.0689655172413793,0.31304347826087,-0.24407796101949
"1058","det",35038,23,9,39.1,95,21,7,33.3,0,2,2,5.8,0.284210526315789,0.192660550458716,0.0915499758570739
"1059","det",35047,27,8,29.6,96,21,5,23.8,0,6,3,5.8,0.25,0.154639175257732,0.095360824742268
"1060","det",35061,18,7,38.9,90,31,10,32.3,1,-13,-3,6.6,0.233333333333333,0.337078651685393,-0.10374531835206
"1061","det",35070,30,7,23.3,105,36,14,38.9,0,-6,-7,-15.6,0.2,0.388888888888889,-0.188888888888889
"1062","det",35106,21,7,33.3,102,30,10,33.3,0,-9,-3,0,0.205882352941176,0.285714285714286,-0.0798319327731092
"1063","det",35122,26,9,34.6,114,51,16,31.4,1,-25,-7,3.2,0.236842105263158,0.440366972477064,-0.203524867213906
"1064","det",35141,28,14,50,103,21,9,42.9,1,7,5,7.1,0.407766990291262,0.3,0.107766990291262
"1065","det",35148,26,10,38.5,101,19,7,36.8,0,7,3,1.7,0.297029702970297,0.2,0.097029702970297
"1066","det",35157,35,11,31.4,109,25,13,52,0,10,-2,-20.6,0.302752293577982,0.345132743362832,-0.0423804497848502
"1067","ind",33945,19,10,52.6,130,48,18,37.5,1,-29,-8,15.1,0.230769230769231,0.446280991735537,-0.215511760966306
"1068","ind",33959,24,7,29.2,94,33,10,30.3,0,-9,-3,-1.1,0.223404255319149,0.29126213592233,-0.0678578806031812
"1069","ind",33970,18,7,38.9,101,21,9,42.9,0,-3,-2,-4,0.207920792079208,0.228813559322034,-0.020892767242826
"1070","ind",33988,28,10,35.7,115,28,6,21.4,1,0,4,14.3,0.260869565217391,0.166666666666667,0.0942028985507246
"1071","ind",34006,23,10,43.5,107,27,12,44.4,0,-4,-2,-0.899999999999999,0.280373831775701,0.288,-0.00762616822429907
"1072","ind",34023,26,12,46.2,111,18,6,33.3,1,8,6,12.9,0.324324324324324,0.191489361702128,0.132834962622197
"1073","ind",34035,33,9,27.3,100,32,12,37.5,0,1,-3,-10.2,0.27,0.295081967213115,-0.0250819672131147
"1074","ind",34050,19,9,47.4,122,36,14,38.9,1,-17,-5,8.5,0.221311475409836,0.365217391304348,-0.143905915894512
"1075","ind",34061,19,5,26.3,105,32,11,34.4,0,-13,-6,-8.1,0.142857142857143,0.302752293577982,-0.159895150720839
"1076","ind",34070,27,6,22.2,99,25,8,32,0,2,-2,-9.8,0.181818181818182,0.228571428571429,-0.0467532467532467
"1077","ind",34085,25,8,32,88,25,5,20,1,0,3,12,0.272727272727273,0.217391304347826,0.0553359683794466
"1078","ind",34100,28,10,35.7,103,30,11,36.7,1,-2,-1,-1,0.29126213592233,0.354838709677419,-0.0635765737550893
"1079","ind",34115,7,1,14.3,96,26,9,34.6,0,-19,-8,-20.3,0.03125,0.232758620689655,-0.201508620689655
"1080","ind",34135,22,11,50,115,36,10,27.8,1,-14,1,22.2,0.28695652173913,0.27027027027027,0.0166862514688602
"1081","ind",34142,23,6,26.1,83,36,13,36.1,0,-13,-7,-10,0.216867469879518,0.325,-0.108132530120482
"1082","ind",34156,27,7,25.9,85,20,5,25,0,7,2,0.899999999999999,0.247058823529412,0.15625,0.0908088235294118
"1083","ind",34174,26,11,42.3,118,34,11,32.4,1,-8,0,9.9,0.279661016949153,0.34020618556701,-0.0605451686178578
"1084","ind",34189,19,5,26.3,91,24,4,16.7,1,-5,1,9.6,0.164835164835165,0.171428571428571,-0.0065934065934066
"1085","ind",34215,14,6,42.9,109,32,12,37.5,0,-18,-6,5.4,0.165137614678899,0.274809160305344,-0.109671545626444
"1086","ind",34243,14,5,35.7,111,30,10,33.3,1,-16,-5,2.40000000000001,0.135135135135135,0.294117647058824,-0.158982511923688
"1087","ind",34254,15,3,20,106,37,14,37.8,0,-22,-11,-17.8,0.0849056603773585,0.295774647887324,-0.210868987509965
"1088","ind",34269,23,7,30.4,109,33,9,27.3,1,-10,-2,3.1,0.192660550458716,0.287234042553192,-0.0945734920944759
"1089","ind",34283,25,14,56,103,32,15,46.9,0,-7,-1,9.1,0.407766990291262,0.405405405405405,0.00236158488585669
"1090","ind",34288,29,15,51.7,118,37,16,43.2,1,-8,-1,8.5,0.38135593220339,0.432432432432432,-0.0510765002290426
"1091","ind",34301,36,17,47.2,110,26,10,38.5,1,10,7,8.7,0.463636363636364,0.319148936170213,0.144487427466151
"1092","ind",34317,27,9,33.3,89,25,7,28,0,2,2,5.3,0.303370786516854,0.221052631578947,0.0823181549379066
"1093","ind",34325,21,3,14.3,95,27,10,37,0,-6,-7,-22.7,0.0947368421052632,0.294117647058824,-0.19938080495356
"1094","ind",34340,19,6,31.6,105,30,10,33.3,1,-11,-4,-1.7,0.171428571428571,0.333333333333333,-0.161904761904762
"1095","ind",34353,21,7,33.3,107,33,8,24.2,1,-12,-1,9.1,0.196261682242991,0.228571428571429,-0.0323097463284379
"1096","ind",34361,23,6,26.1,111,23,13,56.5,0,0,-7,-30.4,0.162162162162162,0.330508474576271,-0.168346312414109
"1097","ind",34380,23,7,30.4,102,39,10,25.6,0,-16,-3,4.8,0.205882352941176,0.275229357798165,-0.0693470048569887
"1098","ind",34405,25,9,36,85,25,6,24,0,0,3,12,0.317647058823529,0.2,0.117647058823529
"1099","ind",34416,28,11,39.3,105,22,8,36.4,0,6,3,2.9,0.314285714285714,0.216216216216216,0.0980694980694981
"1100","ind",34432,19,7,36.8,111,23,6,26.1,1,-4,1,10.7,0.189189189189189,0.178217821782178,0.010971367407011
"1101","ind",34450,22,9,40.9,117,38,10,26.3,1,-16,-1,14.6,0.230769230769231,0.288461538461538,-0.0576923076923077
"1102","ind",34463,16,9,56.2,121,29,10,34.5,1,-13,-1,21.7,0.223140495867769,0.258620689655172,-0.0354801937874038
"1103","ind",34476,22,10,45.4,121,38,17,44.7,1,-16,-7,0.699999999999996,0.247933884297521,0.467889908256881,-0.21995602395936
"1104","ind",34492,24,11,45.8,123,31,12,38.7,1,-7,-1,7.09999999999999,0.268292682926829,0.330275229357798,-0.0619825464309689
"1105","ind",34526,29,12,41.4,112,32,15,46.9,0,-3,-3,-5.5,0.321428571428571,0.321428571428571,0
"1106","ind",34556,19,5,26.3,98,25,10,40,1,-6,-5,-13.7,0.153061224489796,0.315789473684211,-0.162728249194415
"1107","ind",34575,21,7,33.3,106,21,9,42.9,1,0,-2,-9.6,0.19811320754717,0.27,-0.0718867924528302
"1108","ind",34589,24,10,41.7,96,33,14,42.4,0,-9,-4,-0.699999999999996,0.3125,0.388888888888889,-0.0763888888888889
"1109","ind",34599,20,10,50,100,24,6,25,0,-4,4,25,0.3,0.165137614678899,0.134862385321101
"1110","ind",34612,26,7,26.9,103,22,8,36.4,0,4,-1,-9.5,0.203883495145631,0.220183486238532,-0.0162999910929011
"1111","ind",34631,18,10,55.6,109,27,10,37,1,-9,0,18.6,0.275229357798165,0.29126213592233,-0.0160327781241649
"1112","ind",34635,28,10,35.7,115,26,13,50,1,2,-3,-14.3,0.260869565217391,0.351351351351351,-0.0904817861339601
"1113","ind",34653,21,5,23.8,120,39,11,28.2,1,-18,-6,-4.4,0.125,0.326732673267327,-0.201732673267327
"1114","ind",34670,20,9,45,98,24,6,25,1,-4,3,20,0.275510204081633,0.204545454545455,0.0709647495361781
"1115","ind",34687,20,8,40,106,28,11,39.3,1,-8,-3,0.700000000000003,0.226415094339623,0.34020618556701,-0.113791091227388
"1116","ind",34697,24,7,29.2,105,17,6,35.3,1,7,1,-6.1,0.2,0.214285714285714,-0.0142857142857143
"1117","ind",34710,26,8,30.8,93,28,7,25,1,-2,1,5.8,0.258064516129032,0.233333333333333,0.0247311827956989
"1118","ind",34723,25,13,52,117,36,16,44.4,0,-11,-3,7.6,0.333333333333333,0.363636363636364,-0.0303030303030303
"1119","ind",34745,21,4,19,107,29,10,34.5,0,-8,-6,-15.5,0.11214953271028,0.267857142857143,-0.155707610146862
"1120","ind",34749,22,10,45.4,100,31,17,54.8,0,-9,-7,-9.4,0.3,0.439655172413793,-0.139655172413793
"1121","ind",34765,20,9,45,106,15,7,46.7,0,5,2,-1.7,0.254716981132075,0.190909090909091,0.0638078902229846
"1122","ind",34775,24,12,50,104,39,18,46.2,0,-15,-6,3.8,0.346153846153846,0.47787610619469,-0.131722260040844
"1123","ind",34788,18,4,22.2,98,29,15,51.7,0,-11,-11,-29.5,0.122448979591837,0.405405405405405,-0.282956425813569
"1124","ind",34797,26,11,42.3,102,27,9,33.3,1,-1,2,9,0.323529411764706,0.293478260869565,0.0300511508951407
"1125","ind",34809,12,4,33.3,95,31,13,41.9,0,-19,-9,-8.6,0.126315789473684,0.345132743362832,-0.218816953889148
"1126","ind",34826,30,13,43.3,117,45,10,22.2,1,-15,3,21.1,0.333333333333333,0.277777777777778,0.0555555555555555
"1127","ind",34842,24,7,29.2,99,29,9,31,0,-5,-2,-1.8,0.212121212121212,0.27,-0.0578787878787879
"1128","ind",34867,33,15,45.4,97,27,9,33.3,1,6,6,12.1,0.463917525773196,0.28125,0.182667525773196
"1129","ind",34881,30,12,40,88,31,11,35.5,0,-1,1,4.5,0.409090909090909,0.33,0.0790909090909091
"1130","ind",34896,23,11,47.8,115,26,7,26.9,1,-3,4,20.9,0.28695652173913,0.214285714285714,0.0726708074534162
"1131","ind",34907,18,2,11.1,85,17,7,41.2,0,1,-5,-30.1,0.0705882352941176,0.212121212121212,-0.141532976827094
"1132","ind",34927,15,5,33.3,102,32,9,28.1,1,-17,-4,5.2,0.147058823529412,0.275510204081633,-0.128451380552221
"1133","ind",34941,29,8,27.6,81,28,9,32.1,0,1,-1,-4.5,0.296296296296296,0.310344827586207,-0.0140485312899106
"1134","ind",34945,28,12,42.9,98,23,3,13,1,5,9,29.9,0.36734693877551,0.116883116883117,0.250463821892393
"1135","ind",34980,23,6,26.1,91,27,12,44.4,0,-4,-6,-18.3,0.197802197802198,0.310344827586207,-0.112542629784009
"1136","ind",34986,20,10,50,107,26,6,23.1,1,-6,4,26.9,0.280373831775701,0.18,0.100373831775701
"1137","ind",35000,28,11,39.3,100,27,11,40.7,0,1,0,-1.40000000000001,0.33,0.302752293577982,0.0272477064220183
"1138","ind",35015,24,13,54.2,117,27,7,25.9,0,-3,6,28.3,0.333333333333333,0.168,0.165333333333333
"1139","ind",35032,17,7,41.2,107,41,14,34.2,1,-24,-7,7,0.196261682242991,0.446808510638298,-0.250546828395307
"1140","ind",35044,18,5,27.8,114,20,9,45,0,-2,-4,-17.2,0.131578947368421,0.234782608695652,-0.103203661327231
"1141","ind",35056,25,10,40,97,32,12,37.5,0,-7,-2,2.5,0.309278350515464,0.327272727272727,-0.0179943767572633
"1142","ind",35066,26,11,42.3,100,27,14,51.8,0,-1,-3,-9.5,0.33,0.378378378378378,-0.0483783783783784
"1143","ind",35091,41,16,39,130,43,18,41.9,0,-2,-2,-2.9,0.369230769230769,0.4,-0.0307692307692308
"1144","ind",35097,25,12,48,108,23,5,21.7,1,2,7,26.3,0.333333333333333,0.166666666666667,0.166666666666667
"1145","ind",35115,25,8,32,104,24,11,45.8,1,1,-3,-13.8,0.230769230769231,0.370786516853933,-0.140017286084702
"1146","ind",35130,22,11,50,127,30,14,46.7,1,-8,-3,3.3,0.259842519685039,0.375,-0.115157480314961
"1147","ind",35143,16,5,31.2,120,33,13,39.4,1,-17,-8,-8.2,0.125,0.351351351351351,-0.226351351351351
"1148","ind",35166,24,10,41.7,104,29,11,37.9,1,-5,-1,3.8,0.288461538461538,0.383720930232558,-0.0952593917710197
"1149","mil",33948,16,3,18.8,96,23,7,30.4,0,-7,-4,-11.6,0.09375,0.196261682242991,-0.102511682242991
"1150","mil",33971,22,8,36.4,110,34,11,32.4,1,-12,-3,4,0.218181818181818,0.305555555555556,-0.0873737373737374
"1151","mil",33978,17,4,23.5,83,20,5,25,0,-3,-1,-1.5,0.144578313253012,0.153061224489796,-0.00848291123678388
"1152","mil",33991,32,10,31.2,117,26,9,34.6,1,6,1,-3.4,0.256410256410256,0.238938053097345,0.0174722033129112
"1153","mil",34006,27,12,44.4,125,23,10,43.5,1,4,2,0.899999999999999,0.288,0.280373831775701,0.00762616822429907
"1154","mil",34025,33,14,42.4,117,28,10,35.7,1,5,4,6.7,0.358974358974359,0.32967032967033,0.0293040293040293
"1155","mil",34030,29,6,20.7,75,38,9,23.7,0,-9,-3,-3,0.24,0.313953488372093,-0.073953488372093
"1156","mil",34057,18,6,33.3,106,25,9,36,0,-7,-3,-2.7,0.169811320754717,0.241071428571429,-0.0712601078167116
"1157","mil",34077,18,7,38.9,106,30,6,20,1,-12,1,18.9,0.19811320754717,0.1875,0.0106132075471698
"1158","mil",34103,32,8,25,100,32,10,31.2,0,0,-2,-6.2,0.24,0.280373831775701,-0.0403738317757009
"1159","mil",34110,23,7,30.4,73,30,7,23.3,0,-7,0,7.1,0.287671232876712,0.21875,0.0689212328767123
"1160","mil",34131,20,10,50,121,38,14,36.8,0,-18,-4,13.2,0.247933884297521,0.338709677419355,-0.0907757931218341
"1161","mil",34144,29,8,27.6,93,25,7,28,1,4,1,-0.399999999999999,0.258064516129032,0.235955056179775,0.022109459949257
"1162","mil",34172,29,12,41.4,99,32,14,43.8,0,-3,-2,-2.4,0.363636363636364,0.4,-0.0363636363636364
"1163","mil",34188,24,8,33.3,104,28,7,25,1,-4,1,8.3,0.230769230769231,0.21875,0.0120192307692308
"1164","mil",34202,19,7,36.8,118,39,14,35.9,1,-20,-7,0.899999999999999,0.177966101694915,0.415841584158416,-0.237875482463501
"1165","mil",34217,34,15,44.1,111,40,12,30,1,-6,3,14.1,0.405405405405405,0.387096774193548,0.0183086312118571
"1166","mil",34231,24,6,25,112,41,11,26.8,1,-17,-5,-1.8,0.160714285714286,0.320388349514563,-0.159674063800277
"1167","mil",34249,24,6,25,96,28,8,28.6,0,-4,-2,-3.6,0.1875,0.247422680412371,-0.0599226804123711
"1168","mil",34265,24,10,41.7,115,40,17,42.5,1,-16,-7,-0.799999999999997,0.260869565217391,0.476635514018692,-0.2157659488013
"1169","mil",34280,28,12,42.9,110,34,12,35.3,0,-6,0,7.6,0.327272727272727,0.315789473684211,0.0114832535885168
"1170","mil",34286,25,13,52,105,21,8,38.1,0,4,5,13.9,0.371428571428571,0.218181818181818,0.153246753246753
"1171","mil",34302,24,4,16.7,100,25,14,56,0,-1,-10,-39.3,0.12,0.344262295081967,-0.224262295081967
"1172","mil",34324,20,11,55,108,20,5,25,1,0,6,30,0.305555555555556,0.154639175257732,0.150916380297824
"1173","mil",34333,25,10,40,95,21,5,23.8,1,4,5,16.2,0.315789473684211,0.217391304347826,0.0983981693363844
"1174","mil",34363,27,7,25.9,108,40,17,42.5,0,-13,-10,-16.6,0.194444444444444,0.447368421052632,-0.252923976608187
"1175","mil",34369,22,9,40.9,102,27,15,55.6,0,-5,-6,-14.7,0.264705882352941,0.398230088495575,-0.133524206142634
"1176","mil",34387,25,9,36,123,24,7,29.2,1,1,2,6.8,0.219512195121951,0.21875,0.00076219512195122
"1177","mil",34401,21,6,28.6,102,29,12,41.4,0,-8,-6,-12.8,0.176470588235294,0.336448598130841,-0.159978009895547
"1178","mil",34419,22,11,50,119,24,6,25,1,-2,5,25,0.277310924369748,0.191489361702128,0.0858215626676203
"1179","mil",34437,18,8,44.4,99,25,13,52,0,-7,-5,-7.6,0.242424242424242,0.336206896551724,-0.0937826541274817
"1180","mil",34443,15,9,60,116,27,10,37,1,-12,-1,23,0.232758620689655,0.3125,-0.0797413793103448
"1181","mil",34453,19,7,36.8,98,27,9,33.3,1,-8,-2,3.5,0.214285714285714,0.287234042553192,-0.0729483282674772
"1182","mil",34471,28,9,32.1,105,28,13,46.4,1,0,-4,-14.3,0.257142857142857,0.375,-0.117857142857143
"1183","mil",34488,22,12,54.6,111,23,13,56.5,0,-1,-1,-1.9,0.324324324324324,0.336206896551724,-0.0118825722273998
"1184","mil",34502,23,9,39.1,101,32,10,31.2,0,-9,-1,7.9,0.267326732673267,0.280373831775701,-0.0130470991024336
"1185","mil",34515,19,10,52.6,109,30,12,40,1,-11,-2,12.6,0.275229357798165,0.336448598130841,-0.061219240332676
"1186","mil",34534,15,9,60,116,32,12,37.5,1,-17,-3,22.5,0.232758620689655,0.333333333333333,-0.100574712643678
"1187","mil",34547,19,6,31.6,98,26,13,50,0,-7,-7,-18.4,0.183673469387755,0.351351351351351,-0.167677881963596
"1188","mil",34555,14,5,35.7,104,37,14,37.8,0,-23,-9,-2.09999999999999,0.144230769230769,0.371681415929204,-0.227450646698434
"1189","mil",34572,28,7,25,92,44,14,31.8,0,-16,-7,-6.8,0.228260869565217,0.378378378378378,-0.150117508813161
"1190","mil",34583,25,10,40,96,28,8,28.6,0,-3,2,11.4,0.3125,0.214285714285714,0.0982142857142857
"1191","mil",34595,18,6,33.3,97,30,13,43.3,0,-12,-7,-10,0.185567010309278,0.357798165137615,-0.172231154828336
"1192","mil",34610,23,11,47.8,127,35,14,40,1,-12,-3,7.8,0.259842519685039,0.368421052631579,-0.10857853294654
"1193","mil",34624,28,7,25,109,26,12,46.2,0,2,-5,-21.2,0.192660550458716,0.315789473684211,-0.123128923225495
"1194","mil",34638,23,7,30.4,86,25,10,40,0,-2,-3,-9.6,0.244186046511628,0.294117647058824,-0.0499316005471956
"1195","mil",34646,21,9,42.9,108,40,14,35,0,-19,-5,7.9,0.25,0.375,-0.125
"1196","mil",34678,23,9,39.1,88,29,11,37.9,0,-6,-2,1.2,0.306818181818182,0.317307692307692,-0.0104895104895105
"1197","mil",34692,24,9,37.5,117,28,9,32.1,0,-4,0,5.4,0.230769230769231,0.223140495867769,0.00762873490146218
"1198","mil",34701,17,7,41.2,137,28,11,39.3,1,-11,-4,1.90000000000001,0.153284671532847,0.294642857142857,-0.14135818561001
"1199","mil",34727,15,6,40,88,33,11,33.3,0,-18,-5,6.7,0.204545454545455,0.311320754716981,-0.106775300171527
"1200","mil",34742,28,8,28.6,114,30,15,50,0,-2,-7,-21.4,0.210526315789474,0.368852459016393,-0.15832614322692
"1201","mil",34749,31,17,54.8,116,22,10,45.4,1,9,7,9.4,0.439655172413793,0.3,0.139655172413793
"1202","mil",34764,21,6,28.6,102,21,7,33.3,1,0,-1,-4.7,0.176470588235294,0.235955056179775,-0.0594844679444811
"1203","mil",34778,15,7,46.7,129,36,14,38.9,1,-21,-7,7.8,0.162790697674419,0.336,-0.173209302325581
"1204","mil",34800,18,7,38.9,95,23,8,34.8,0,-5,-1,4.1,0.221052631578947,0.220183486238532,0.000869145340415239
"1205","mil",34815,20,6,30,100,14,5,35.7,1,6,1,-5.7,0.18,0.15625,0.02375
"1206","mil",34824,29,11,37.9,95,27,10,37,0,2,1,0.899999999999999,0.347368421052632,0.294117647058824,0.0532507739938081
"1207","mil",34840,18,9,50,98,33,10,30.3,0,-15,-1,19.7,0.275510204081633,0.272727272727273,0.00278293135435992
"1208","mil",34852,25,10,40,112,19,8,42.1,1,6,2,-2.1,0.267857142857143,0.237623762376238,0.0302333804809052
"1209","mil",34860,27,6,22.2,101,21,7,33.3,1,6,-1,-11.1,0.178217821782178,0.223404255319149,-0.0451864335369707
"1210","mil",34874,33,14,42.4,112,30,8,26.7,1,3,6,15.7,0.375,0.244897959183673,0.130102040816327
"1211","mil",34892,26,8,30.8,104,20,7,35,1,6,1,-4.2,0.230769230769231,0.225806451612903,0.00496277915632756
"1212","mil",34907,17,7,41.2,99,18,2,11.1,1,-1,5,30.1,0.212121212121212,0.0705882352941176,0.141532976827094
"1213","mil",34918,20,8,40,102,13,5,38.5,1,7,3,1.5,0.235294117647059,0.157894736842105,0.0773993808049536
"1214","mil",34933,26,14,53.8,93,27,14,51.8,0,-1,0,2,0.451612903225806,0.371681415929204,0.0799314872966029
"1215","mil",34953,29,10,34.5,97,24,5,20.8,1,5,5,13.7,0.309278350515464,0.15625,0.153028350515464
"1216","mil",34967,24,4,16.7,107,29,11,37.9,1,-5,-7,-21.2,0.11214953271028,0.320388349514563,-0.208238816804283
"1217","mil",34975,27,9,33.3,92,23,12,52.2,0,4,-3,-18.9,0.293478260869565,0.307692307692308,-0.0142140468227425
"1218","mil",34997,16,7,43.8,93,21,4,19,1,-5,3,24.8,0.225806451612903,0.133333333333333,0.0924731182795699
"1219","mil",35005,35,16,45.7,116,26,10,38.5,1,9,6,7.2,0.413793103448276,0.306122448979592,0.107670654468684
"1220","mil",35018,27,8,29.6,100,22,8,36.4,1,5,0,-6.8,0.24,0.247422680412371,-0.00742268041237115
"1221","mil",35030,23,7,30.4,94,21,10,47.6,0,2,-3,-17.2,0.223404255319149,0.275229357798165,-0.0518251024790162
"1222","mil",35043,30,14,46.7,118,28,7,25,1,2,7,21.7,0.355932203389831,0.194444444444444,0.161487758945386
"1223","mil",35053,22,8,36.4,103,37,12,32.4,1,-15,-4,4,0.233009708737864,0.36,-0.126990291262136
"1224","mil",35070,36,14,38.9,108,30,7,23.3,1,6,7,15.6,0.388888888888889,0.2,0.188888888888889
"1225","mil",35085,34,12,35.3,105,36,14,38.9,0,-2,-2,-3.6,0.342857142857143,0.385321100917431,-0.0424639580602884
"1226","mil",35099,18,3,16.7,79,28,9,32.1,0,-10,-6,-15.4,0.113924050632911,0.245454545454545,-0.131530494821634
"1227","mil",35115,24,11,45.8,89,25,8,32,0,-1,3,13.8,0.370786516853933,0.230769230769231,0.140017286084702
"1228","mil",35131,27,6,22.2,90,31,8,25.8,1,-4,-2,-3.6,0.2,0.292682926829268,-0.0926829268292683
"1229","mil",35147,28,16,57.1,89,18,5,27.8,1,10,11,29.3,0.539325842696629,0.189873417721519,0.34945242497511
"1230","mil",35159,23,6,26.1,94,37,12,32.4,0,-14,-6,-6.3,0.191489361702128,0.321428571428571,-0.129939209726444
"1231","dal",33945,48,18,37.5,121,19,10,52.6,0,29,8,-15.1,0.446280991735537,0.230769230769231,0.215511760966306
"1232","dal",33963,29,8,27.6,98,32,15,46.9,0,-3,-7,-19.3,0.244897959183673,0.424528301886792,-0.179630342703119
"1233","dal",33981,30,11,36.7,92,31,11,35.5,0,-1,0,1.2,0.358695652173913,0.354838709677419,0.00385694249649365
"1234","dal",34002,26,7,26.9,81,25,12,48,0,1,-5,-21.1,0.259259259259259,0.371134020618557,-0.111874761359297
"1235","dal",34016,28,10,35.7,95,31,12,38.7,0,-3,-2,-3,0.315789473684211,0.342857142857143,-0.0270676691729324
"1236","dal",34030,38,9,23.7,86,29,6,20.7,1,9,3,3,0.313953488372093,0.24,0.073953488372093
"1237","dal",34044,23,10,43.5,109,26,10,38.5,1,-3,0,5,0.275229357798165,0.309278350515464,-0.0340489927172988
"1238","dal",34056,28,6,21.4,95,33,17,51.5,0,-5,-11,-30.1,0.189473684210526,0.439655172413793,-0.250181488203267
"1239","dal",34086,27,5,18.5,77,25,9,36,0,2,-4,-17.5,0.194805194805195,0.290322580645161,-0.0955173858399665
"1240","dal",34101,23,8,34.8,83,21,7,33.3,0,2,1,1.5,0.289156626506024,0.233333333333333,0.0558232931726907
"1241","dal",34120,25,5,20,64,25,9,36,0,0,-4,-16,0.234375,0.3375,-0.103125
"1242","dal",34127,28,13,46.4,87,21,8,38.1,0,7,5,8.3,0.448275862068966,0.252631578947368,0.195644283121597
"1243","dal",34146,27,8,29.6,91,20,8,40,0,7,0,-10.4,0.263736263736264,0.25,0.0137362637362637
"1244","dal",34160,24,11,45.8,104,32,15,46.9,0,-8,-4,-1.1,0.317307692307692,0.362903225806452,-0.0455955334987593
"1245","dal",34167,35,8,22.9,90,43,20,46.5,0,-8,-12,-23.6,0.266666666666667,0.46875,-0.202083333333333
"1246","dal",34190,27,10,37,91,20,5,25,1,7,5,12,0.32967032967033,0.185185185185185,0.144485144485144
"1247","dal",34212,30,10,33.3,87,19,11,57.9,0,11,-1,-24.6,0.344827586206897,0.351063829787234,-0.00623624358033747
"1248","dal",34216,31,9,29,87,18,5,27.8,0,13,4,1.2,0.310344827586207,0.154639175257732,0.155705652328475
"1249","dal",34236,31,13,41.9,107,13,3,23.1,1,18,10,18.8,0.364485981308411,0.109756097560976,0.254729883747436
"1250","dal",34252,36,13,36.1,101,18,3,16.7,0,18,10,19.4,0.386138613861386,0.0825688073394495,0.303569806521937
"1251","dal",34268,30,10,33.3,89,22,10,45.4,0,8,0,-12.1,0.337078651685393,0.25,0.0870786516853932
"1252","dal",34283,32,15,46.9,111,25,14,56,1,7,1,-9.1,0.405405405405405,0.407766990291262,-0.00236158488585669
"1253","dal",34292,34,11,32.4,87,37,19,51.4,0,-3,-8,-19,0.379310344827586,0.522935779816514,-0.143625434988928
"1254","dal",34305,26,12,46.2,112,25,7,28,1,1,5,18.2,0.321428571428571,0.228260869565217,0.0931677018633541
"1255","dal",34321,25,8,32,85,17,5,29.4,0,8,3,2.6,0.282352941176471,0.157894736842105,0.124458204334365
"1256","dal",34338,28,12,42.9,100,22,8,36.4,0,6,4,6.5,0.36,0.233009708737864,0.126990291262136
"1257","dal",34351,33,13,39.4,99,31,8,25.8,1,2,5,13.6,0.393939393939394,0.30379746835443,0.0901419255849635
"1258","dal",34357,25,14,56,107,25,13,52,0,0,1,4,0.392523364485981,0.333333333333333,0.059190031152648
"1259","dal",34376,31,7,22.6,96,27,10,37,1,4,-3,-14.4,0.21875,0.315789473684211,-0.0970394736842105
"1260","dal",34395,29,7,24.1,90,29,13,44.8,1,0,-6,-20.7,0.233333333333333,0.443181818181818,-0.209848484848485
"1261","dal",34406,32,13,40.6,104,25,12,48,0,7,1,-7.4,0.375,0.324324324324324,0.0506756756756757
"1262","dal",34414,38,15,39.5,107,32,17,53.1,0,6,-2,-13.6,0.420560747663551,0.414634146341463,0.005926601322088
"1263","dal",34431,31,14,45.2,101,19,7,36.8,1,12,7,8.40000000000001,0.415841584158416,0.235955056179775,0.179886527978641
"1264","dal",34441,32,8,25,99,33,11,33.3,0,-1,-3,-8.3,0.242424242424242,0.305555555555556,-0.0631313131313131
"1265","dal",34464,32,17,53.1,113,30,11,36.7,1,2,6,16.4,0.451327433628319,0.314285714285714,0.137041719342604
"1266","dal",34481,29,9,31,95,17,7,41.2,0,12,2,-10.2,0.284210526315789,0.205882352941176,0.078328173374613
"1267","dal",34497,36,9,25,82,22,11,50,0,14,-2,-25,0.329268292682927,0.34020618556701,-0.0109378928840835
"1268","dal",34510,28,13,46.4,92,16,6,37.5,0,12,7,8.9,0.423913043478261,0.178217821782178,0.245695221696083
"1269","dal",34530,34,15,44.1,113,18,10,55.6,1,16,5,-11.5,0.398230088495575,0.277777777777778,0.120452310717797
"1270","dal",34548,29,12,41.4,98,21,5,23.8,1,8,7,17.6,0.36734693877551,0.172413793103448,0.194933145672062
"1271","dal",34564,28,11,39.3,99,14,6,42.9,1,14,5,-3.6,0.333333333333333,0.183673469387755,0.149659863945578
"1272","dal",34577,36,14,38.9,95,20,9,45,0,16,5,-6.1,0.442105263157895,0.272727272727273,0.169377990430622
"1273","dal",34588,23,8,34.8,107,23,8,34.8,0,0,0,0,0.224299065420561,0.214285714285714,0.0100133511348465
"1274","dal",34602,39,17,43.6,122,21,3,14.3,1,18,14,29.3,0.418032786885246,0.123287671232877,0.294745115652369
"1275","dal",34628,26,6,23.1,103,23,7,30.4,1,3,-1,-7.3,0.174757281553398,0.221052631578947,-0.0462953500255493
"1276","dal",34630,26,11,42.3,98,22,9,40.9,0,4,2,1.4,0.336734693877551,0.247706422018349,0.0890282718592024
"1277","dal",34657,34,12,35.3,105,22,8,36.4,1,12,4,-1.1,0.342857142857143,0.237623762376238,0.105233380480905
"1278","dal",34662,32,9,28.1,104,32,12,37.5,1,0,-3,-9.4,0.259615384615385,0.371134020618557,-0.111518636003172
"1279","dal",34676,26,10,38.5,113,22,6,27.3,1,4,4,11.2,0.265486725663717,0.189473684210526,0.0760130414531905
"1280","dal",34694,31,17,54.8,108,30,9,30,1,1,8,24.8,0.472222222222222,0.259615384615385,0.212606837606838
"1281","dal",34716,26,8,30.8,87,28,11,39.3,0,-2,-3,-8.5,0.275862068965517,0.3,-0.0241379310344828
"1282","dal",34721,28,12,42.9,113,28,11,39.3,0,0,1,3.6,0.31858407079646,0.289473684210526,0.0291103865859338
"1283","dal",34737,20,5,25,112,29,13,44.8,1,-9,-8,-19.8,0.133928571428571,0.371428571428571,-0.2375
"1284","dal",34754,35,17,48.6,112,23,3,13,1,12,14,35.6,0.455357142857143,0.1125,0.342857142857143
"1285","dal",34766,27,9,33.3,98,34,16,47.1,0,-7,-7,-13.8,0.275510204081633,0.432432432432432,-0.1569222283508
"1286","dal",34779,36,10,27.8,91,20,6,30,0,16,4,-2.2,0.32967032967033,0.183673469387755,0.145996860282575
"1287","dal",34802,33,8,24.2,84,13,5,38.5,0,20,3,-14.3,0.285714285714286,0.154639175257732,0.131075110456554
"1288","dal",34810,26,12,46.2,96,24,5,20.8,1,2,7,25.4,0.375,0.180722891566265,0.194277108433735
"1289","dal",34827,18,9,50,96,26,9,34.6,1,-8,0,15.4,0.28125,0.303370786516854,-0.022120786516854
"1290","dal",34837,33,14,42.4,95,21,10,47.6,0,12,4,-5.2,0.442105263157895,0.3,0.142105263157895
"1291","dal",34854,27,5,18.5,104,28,9,32.1,1,-1,-4,-13.6,0.144230769230769,0.27,-0.125769230769231
"1292","dal",34872,25,7,28,104,22,2,9.1,1,3,5,18.9,0.201923076923077,0.0674157303370786,0.134507346585998
"1293","dal",34887,31,17,54.8,122,30,11,36.7,1,1,6,18.1,0.418032786885246,0.297297297297297,0.120735489587949
"1294","dal",34911,33,14,42.4,105,31,9,29,1,2,5,13.4,0.4,0.28125,0.11875
"1295","dal",34922,26,9,34.6,98,20,6,30,0,6,3,4.6,0.275510204081633,0.18,0.0955102040816326
"1296","dal",34932,25,7,28,78,25,9,36,0,0,-2,-8,0.269230769230769,0.27,-0.0007692307692308
"1297","dal",34944,32,14,43.8,112,30,12,40,1,2,2,3.8,0.375,0.336448598130841,0.0385514018691589
"1298","dal",34960,23,5,21.7,74,29,12,41.4,0,-6,-7,-19.7,0.202702702702703,0.310344827586207,-0.107642124883504
"1299","dal",34976,25,10,40,111,31,13,41.9,1,-6,-3,-1.9,0.27027027027027,0.375,-0.10472972972973
"1300","dal",34995,34,11,32.4,87,30,13,43.3,0,4,-2,-10.9,0.379310344827586,0.348214285714286,0.0310960591133005
"1301","dal",35009,26,9,34.6,97,27,9,33.3,1,-1,0,1.3,0.278350515463918,0.284210526315789,-0.00586001085187193
"1302","dal",35024,28,7,25,86,21,9,42.9,0,7,-2,-17.9,0.244186046511628,0.287234042553192,-0.0430479960415636
"1303","dal",35040,29,10,34.5,91,23,6,26.1,0,6,4,8.4,0.32967032967033,0.195652173913043,0.134018155757286
"1304","dal",35057,27,14,51.8,118,30,12,40,0,-3,2,11.8,0.355932203389831,0.297520661157025,0.0584115422328057
"1305","dal",35071,34,12,35.3,90,27,11,40.7,0,7,1,-5.40000000000001,0.4,0.333333333333333,0.0666666666666667
"1306","dal",35085,36,14,38.9,109,34,12,35.3,1,2,2,3.6,0.385321100917431,0.342857142857143,0.0424639580602884
"1307","dal",35103,43,12,27.9,87,22,12,54.6,0,21,0,-26.7,0.413793103448276,0.36734693877551,0.0464461646727656
"1308","dal",35112,31,11,35.5,101,31,12,38.7,0,0,-1,-3.2,0.326732673267327,0.321428571428571,0.00530410183875529
"1309","dal",35123,27,8,29.6,89,28,9,32.1,0,-1,-1,-2.5,0.269662921348315,0.264705882352941,0.00495703899537342
"1310","dal",35139,45,16,35.6,111,19,8,42.1,0,26,8,-6.5,0.432432432432432,0.193548387096774,0.238884045335658
"1311","dal",35154,40,12,30,91,42,18,42.9,0,-2,-6,-12.9,0.395604395604396,0.495412844036697,-0.0998084484323017
"1312","dal",35163,34,9,26.5,100,25,8,32,1,9,1,-5.5,0.27,0.258064516129032,0.0119354838709678
"1313","hou",33953,29,7,24.1,114,35,12,34.3,0,-6,-5,-10.2,0.184210526315789,0.3,-0.115789473684211
"1314","hou",33963,32,15,46.9,106,29,8,27.6,1,3,7,19.3,0.424528301886792,0.244897959183673,0.179630342703119
"1315","hou",33981,31,11,35.5,93,30,11,36.7,1,1,0,-1.2,0.354838709677419,0.358695652173913,-0.00385694249649365
"1316","hou",33987,44,17,38.6,120,32,16,50,0,12,1,-11.4,0.425,0.375,0.05
"1317","hou",33998,40,15,37.5,118,20,8,40,1,20,7,-2.5,0.38135593220339,0.242424242424242,0.138931689779147
"1318","hou",34024,36,12,33.3,97,20,8,40,0,16,4,-6.7,0.371134020618557,0.214285714285714,0.156848306332842
"1319","hou",34034,37,17,46,114,27,10,37,1,10,7,9,0.447368421052632,0.283018867924528,0.164349553128103
"1320","hou",34054,30,10,33.3,101,23,7,30.4,1,7,3,2.9,0.297029702970297,0.212121212121212,0.0849084908490849
"1321","hou",34074,47,15,31.9,100,18,5,27.8,0,29,10,4.1,0.45,0.141509433962264,0.308490566037736
"1322","hou",34089,40,17,42.5,115,22,5,22.7,1,18,12,19.8,0.443478260869565,0.170454545454545,0.27302371541502
"1323","hou",34104,40,14,35,103,25,12,48,0,15,2,-13,0.407766990291262,0.342857142857143,0.0649098474341193
"1324","hou",34111,32,14,43.8,126,28,10,35.7,1,4,4,8.09999999999999,0.333333333333333,0.275229357798165,0.0581039755351682
"1325","hou",34124,32,12,37.5,111,27,12,44.4,1,5,0,-6.9,0.324324324324324,0.352941176470588,-0.0286168521462639
"1326","hou",34143,31,10,32.3,99,17,7,41.2,1,14,3,-8.90000000000001,0.303030303030303,0.21875,0.084280303030303
"1327","hou",34159,42,14,33.3,102,23,12,52.2,0,19,2,-18.9,0.411764705882353,0.31304347826087,0.0987212276214833
"1328","hou",34179,50,21,42,117,32,9,28.1,1,18,12,13.9,0.538461538461538,0.259615384615385,0.278846153846154
"1329","hou",34191,36,17,47.2,130,33,12,36.4,1,3,5,10.8,0.392307692307692,0.315789473684211,0.0765182186234818
"1330","hou",34205,30,11,36.7,101,28,15,53.6,0,2,-4,-16.9,0.326732673267327,0.375,-0.0482673267326733
"1331","hou",34221,44,14,31.8,132,44,12,27.3,1,0,2,4.5,0.318181818181818,0.283464566929134,0.0347172512526843
"1332","hou",34230,37,17,46,128,31,9,29,1,6,8,17,0.3984375,0.245454545454545,0.152982954545455
"1333","hou",34251,38,12,31.6,107,32,11,34.4,1,6,1,-2.8,0.336448598130841,0.311320754716981,0.02512784341386
"1334","hou",34266,36,15,41.7,134,20,5,25,1,16,10,16.7,0.335820895522388,0.157894736842105,0.177926158680283
"1335","hou",34281,42,11,26.2,102,28,7,25,1,14,4,1.2,0.323529411764706,0.212121212121212,0.111408199643494
"1336","hou",34292,37,19,51.4,109,34,11,32.4,1,3,8,19,0.522935779816514,0.379310344827586,0.143625434988928
"1337","hou",34304,43,17,39.5,122,20,7,35,1,23,10,4.5,0.418032786885246,0.177966101694915,0.240066685190331
"1338","hou",34320,42,22,52.4,132,32,11,34.4,1,10,11,18,0.5,0.336734693877551,0.163265306122449
"1339","hou",34335,61,24,39.3,122,27,9,33.3,1,34,15,6,0.590163934426229,0.27,0.320163934426229
"1340","hou",34343,51,17,33.3,111,21,7,33.3,1,30,10,0,0.459459459459459,0.192660550458716,0.266798909000744
"1341","hou",34365,38,6,15.8,100,23,12,52.2,0,15,-6,-36.4,0.18,0.352941176470588,-0.172941176470588
"1342","hou",34375,38,18,47.4,125,25,9,36,1,13,9,11.4,0.432,0.243243243243243,0.188756756756757
"1343","hou",34388,52,20,38.5,109,25,13,52,0,27,7,-13.5,0.55045871559633,0.339130434782609,0.211328280813722
"1344","hou",34407,43,15,34.9,131,30,7,23.3,1,13,8,11.6,0.343511450381679,0.182608695652174,0.160902754729505
"1345","hou",34414,32,17,53.1,123,38,15,39.5,1,-6,2,13.6,0.414634146341463,0.420560747663551,-0.005926601322088
"1346","hou",34436,40,14,35,140,33,13,39.4,1,7,1,-4.4,0.3,0.336206896551724,-0.0362068965517242
"1347","hou",34445,55,21,38.2,129,32,10,31.2,1,23,11,7,0.488372093023256,0.245901639344262,0.242470453678994
"1348","hou",34458,39,12,30.8,101,26,6,23.1,1,13,6,7.7,0.356435643564356,0.197802197802198,0.158633445762159
"1349","hou",34480,39,15,38.5,118,30,12,40,1,9,3,-1.5,0.38135593220339,0.310344827586207,0.0710111046171829
"1350","hou",34485,49,15,30.6,100,23,8,34.8,1,26,7,-4.2,0.45,0.258064516129032,0.191935483870968
"1351","hou",34503,38,11,29,129,25,11,44,1,13,0,-15,0.255813953488372,0.270491803278689,-0.0146778497903164
"1352","hou",34514,39,17,43.6,121,43,19,44.2,1,-4,-2,-0.600000000000001,0.421487603305785,0.5,-0.0785123966942149
"1353","hou",34522,42,15,35.7,105,23,8,34.8,0,19,7,0.900000000000006,0.428571428571429,0.201680672268908,0.226890756302521
"1354","hou",34535,41,10,24.4,105,27,10,37,0,14,0,-12.6,0.285714285714286,0.272727272727273,0.012987012987013
"1355","hou",34549,44,21,47.7,137,44,15,34.1,1,0,6,13.6,0.45985401459854,0.401785714285714,0.0580683003128258
"1356","hou",34563,39,9,23.1,103,29,9,31,0,10,0,-7.9,0.262135922330097,0.247706422018349,0.0144295003117484
"1357","hou",34572,44,14,31.8,111,28,7,25,1,16,7,6.8,0.378378378378378,0.228260869565217,0.150117508813161
"1358","hou",34586,35,7,20,108,38,15,39.5,0,-3,-8,-19.5,0.194444444444444,0.36,-0.165555555555556
"1359","hou",34596,42,16,38.1,119,34,9,26.5,1,8,7,11.6,0.403361344537815,0.284210526315789,0.119150818222026
"1360","hou",34610,35,14,40,114,23,11,47.8,0,12,3,-7.8,0.368421052631579,0.259842519685039,0.10857853294654
"1361","hou",34621,31,10,32.3,109,32,11,34.4,0,-1,-1,-2.1,0.275229357798165,0.275,0.000229357798165131
"1362","hou",34634,31,12,38.7,123,25,10,40,1,6,2,-1.3,0.292682926829268,0.254237288135593,0.0384456386936751
"1363","hou",34653,39,11,28.2,101,21,5,23.8,0,18,6,4.4,0.326732673267327,0.125,0.201732673267327
"1364","hou",34666,45,14,31.1,105,29,8,27.6,1,16,6,3.5,0.4,0.289156626506024,0.110843373493976
"1365","hou",34683,51,13,25.5,108,30,8,26.7,0,21,5,-1.2,0.361111111111111,0.212389380530973,0.148721730580138
"1366","hou",34689,43,16,37.2,121,25,8,32,1,18,8,5.2,0.396694214876033,0.205128205128205,0.191566009747828
"1367","hou",34720,38,16,42.1,128,25,6,24,1,13,10,18.1,0.375,0.173076923076923,0.201923076923077
"1368","hou",34734,40,13,32.5,107,26,8,30.8,1,14,5,1.7,0.364485981308411,0.252631578947368,0.111854402361043
"1369","hou",34753,36,18,50,133,22,8,36.4,1,14,10,13.6,0.406015037593985,0.235294117647059,0.170720919946926
"1370","hou",34781,40,13,32.5,109,35,13,37.1,0,5,0,-4.6,0.357798165137615,0.333333333333333,0.0244648318042814
"1371","hou",34792,51,20,39.2,129,31,6,19.4,1,20,14,19.8,0.465116279069767,0.181818181818182,0.283298097251586
"1372","hou",34812,58,22,37.9,142,26,9,34.6,1,32,13,3.3,0.464788732394366,0.207692307692308,0.257096424702059
"1373","hou",34826,45,10,22.2,108,30,13,43.3,0,15,-3,-21.1,0.277777777777778,0.333333333333333,-0.0555555555555555
"1374","hou",34844,52,20,38.5,122,34,12,35.3,1,18,8,3.2,0.491803278688525,0.349514563106796,0.142288715581728
"1375","hou",34864,42,18,42.9,123,28,8,28.6,1,14,10,14.3,0.439024390243902,0.222222222222222,0.21680216802168
"1376","hou",34882,39,14,35.9,110,27,11,40.7,0,12,3,-4.8,0.381818181818182,0.294642857142857,0.0871753246753247
"1377","hou",34894,32,8,25,108,31,12,38.7,0,1,-4,-13.7,0.222222222222222,0.31304347826087,-0.0908212560386474
"1378","hou",34906,47,15,31.9,115,39,9,23.1,1,8,6,8.8,0.391304347826087,0.287234042553192,0.104070305272895
"1379","hou",34929,45,16,35.6,117,43,17,39.5,1,2,-1,-3.9,0.41025641025641,0.455357142857143,-0.0451007326007326
"1380","hou",34950,43,18,41.9,139,25,3,12,1,18,15,29.9,0.388489208633094,0.09,0.298489208633094
"1381","hou",34964,40,13,32.5,112,34,12,35.3,0,6,1,-2.8,0.348214285714286,0.28125,0.0669642857142857
"1382","hou",34974,24,5,20.8,109,31,10,32.3,1,-7,-5,-11.5,0.137614678899083,0.285714285714286,-0.148099606815203
"1383","hou",34988,38,17,44.7,125,29,12,41.4,1,9,5,3.3,0.408,0.290322580645161,0.117677419354839
"1384","hou",35019,39,14,35.9,117,38,14,36.8,1,1,0,-0.899999999999999,0.358974358974359,0.392523364485981,-0.0335490055116223
"1385","hou",35031,39,20,51.3,137,30,11,36.7,1,9,9,14.6,0.437956204379562,0.264,0.173956204379562
"1386","hou",35048,31,5,16.1,106,41,11,26.8,0,-10,-6,-10.7,0.141509433962264,0.292035398230089,-0.150525964267824
"1387","hou",35065,34,8,23.5,107,33,13,39.4,0,1,-5,-15.9,0.224299065420561,0.333333333333333,-0.109034267912773
"1388","hou",35076,37,12,32.4,98,32,11,34.4,0,5,1,-2,0.36734693877551,0.308411214953271,0.0589357238222392
"1389","hou",35093,38,14,36.8,123,34,8,23.5,1,4,6,13.3,0.341463414634146,0.206896551724138,0.134566862910008
"1390","hou",35108,34,10,29.4,110,38,7,18.4,1,-4,3,11,0.272727272727273,0.201923076923077,0.0708041958041958
"1391","hou",35122,51,16,31.4,109,26,9,34.6,0,25,7,-3.2,0.440366972477064,0.236842105263158,0.203524867213906
"1392","hou",35140,43,18,41.9,135,31,9,29,1,12,9,12.9,0.4,0.2109375,0.1890625
"1393","hou",35150,40,9,22.5,96,26,10,38.5,0,14,-1,-16,0.28125,0.24,0.04125
"1394","hou",35164,56,19,33.9,123,23,11,47.8,1,33,8,-13.9,0.463414634146341,0.279661016949153,0.183753617197189
"1395","mem",33949,24,11,45.8,102,18,6,33.3,1,6,5,12.5,0.323529411764706,0.183673469387755,0.139855942376951
"1396","mem",33968,25,9,36,104,21,6,28.6,0,4,3,7.4,0.259615384615385,0.162162162162162,0.0974532224532225
"1397","mem",33979,31,15,48.4,112,25,5,20,1,6,10,28.4,0.401785714285714,0.145631067961165,0.256154646324549
"1398","mem",33992,24,4,16.7,80,20,12,60,0,4,-8,-43.3,0.15,0.310344827586207,-0.160344827586207
"1399","mem",34000,27,8,29.6,89,34,11,32.4,1,-7,-3,-2.8,0.269662921348315,0.397590361445783,-0.127927440097469
"1400","mem",34014,26,9,34.6,88,27,8,29.6,0,-1,1,5,0.306818181818182,0.242424242424242,0.0643939393939394
"1401","mem",34028,26,6,23.1,94,33,14,42.4,0,-7,-8,-19.3,0.191489361702128,0.42,-0.228510638297872
"1402","mem",34042,24,7,29.2,108,24,10,41.7,1,0,-3,-12.5,0.194444444444444,0.280373831775701,-0.0859293873312565
"1403","mem",34077,30,6,20,96,18,7,38.9,0,12,-1,-18.9,0.1875,0.19811320754717,-0.0106132075471698
"1404","mem",34091,21,8,38.1,102,28,8,28.6,1,-7,0,9.5,0.235294117647059,0.25,-0.0147058823529412
"1405","mem",34107,26,15,57.7,111,25,9,36,1,1,6,21.7,0.405405405405405,0.252336448598131,0.153068956807275
"1406","mem",34120,25,9,36,80,25,5,20,1,0,4,16,0.3375,0.234375,0.103125
"1407","mem",34130,18,2,11.1,93,22,7,31.8,1,-4,-5,-20.7,0.0645161290322581,0.295774647887324,-0.231258518855066
"1408","mem",34141,26,12,46.2,105,31,9,29,1,-5,3,17.2,0.342857142857143,0.3,0.0428571428571429
"1409","mem",34152,29,10,34.5,104,36,12,33.3,1,-7,-2,1.2,0.288461538461538,0.363636363636364,-0.0751748251748252
"1410","mem",34173,19,4,21,81,31,12,38.7,0,-12,-8,-17.7,0.148148148148148,0.4,-0.251851851851852
"1411","mem",34183,25,9,36,110,31,11,35.5,1,-6,-2,0.5,0.245454545454545,0.308411214953271,-0.0629566694987256
"1412","mem",34197,29,7,24.1,85,26,9,34.6,0,3,-2,-10.5,0.247058823529412,0.259615384615385,-0.0125565610859729
"1413","mem",34208,27,11,40.7,105,32,16,50,0,-5,-5,-9.3,0.314285714285714,0.4,-0.0857142857142857
"1414","mem",34218,18,7,38.9,95,24,6,25,1,-6,1,13.9,0.221052631578947,0.191489361702128,0.0295632698768197
"1415","mem",34235,30,10,33.3,103,21,7,33.3,1,9,3,0,0.29126213592233,0.21,0.0812621359223301
"1416","mem",34250,34,13,38.2,110,32,10,31.2,1,2,3,7,0.354545454545455,0.277777777777778,0.0767676767676768
"1417","mem",34258,17,2,11.8,96,41,14,34.2,1,-24,-12,-22.4,0.0625,0.461538461538462,-0.399038461538462
"1418","mem",34273,20,6,30,88,28,7,25,1,-8,-1,5,0.204545454545455,0.244186046511628,-0.0396405919661733
"1419","mem",34291,26,8,30.8,110,27,9,33.3,1,-1,-1,-2.5,0.218181818181818,0.303370786516854,-0.0851889683350358
"1420","mem",34308,22,4,18.2,86,31,12,38.7,0,-9,-8,-20.5,0.13953488372093,0.349514563106796,-0.209979679385866
"1421","mem",34319,23,12,52.2,93,25,9,36,1,-2,3,16.2,0.387096774193548,0.317647058823529,0.069449715370019
"1422","mem",34334,25,5,20,92,24,7,29.2,0,1,-2,-9.2,0.16304347826087,0.21875,-0.0557065217391304
"1423","mem",34347,23,2,8.7,73,27,8,29.6,0,-4,-6,-20.9,0.0821917808219178,0.292682926829268,-0.21049114600735
"1424","mem",34364,30,12,40,109,37,12,32.4,0,-7,0,7.6,0.330275229357798,0.321428571428571,0.00884665792922673
"1425","mem",34371,30,12,40,98,23,6,26.1,1,7,6,13.9,0.36734693877551,0.209302325581395,0.158044613194115
"1426","mem",34388,25,13,52,115,52,20,38.5,1,-27,-7,13.5,0.339130434782609,0.55045871559633,-0.211328280813722
"1427","mem",34402,25,10,40,102,26,13,50,0,-1,-3,-10,0.294117647058824,0.348214285714286,-0.0540966386554622
"1428","mem",34412,30,9,30,103,31,12,38.7,0,-1,-3,-8.7,0.262135922330097,0.31858407079646,-0.0564481484663631
"1429","mem",34427,22,13,59.1,114,22,4,18.2,1,0,9,40.9,0.342105263157895,0.15,0.192105263157895
"1430","mem",34442,35,17,48.6,112,28,11,39.3,1,7,6,9.3,0.455357142857143,0.336734693877551,0.118622448979592
"1431","mem",34468,31,10,32.3,102,33,17,51.5,0,-2,-7,-19.2,0.294117647058824,0.439655172413793,-0.14553752535497
"1432","mem",34473,28,11,39.3,106,23,9,39.1,0,5,2,0.199999999999996,0.311320754716981,0.234782608695652,0.0765381460213289
"1433","mem",34490,33,13,39.4,128,30,8,26.7,1,3,5,12.7,0.3046875,0.201680672268908,0.103006827731092
"1434","mem",34504,24,9,37.5,88,23,9,39.1,1,1,0,-1.6,0.306818181818182,0.341772151898734,-0.0349539700805523
"1435","mem",34521,24,7,29.2,95,26,8,30.8,0,-2,-1,-1.6,0.221052631578947,0.233009708737864,-0.0119570771589167
"1436","mem",34535,27,10,37,110,41,10,24.4,1,-14,0,12.6,0.272727272727273,0.285714285714286,-0.012987012987013
"1437","mem",34551,32,11,34.4,104,17,4,23.5,0,15,7,10.9,0.317307692307692,0.111111111111111,0.206196581196581
"1438","mem",34568,25,8,32,101,29,8,27.6,0,-4,0,4.4,0.237623762376238,0.230769230769231,0.00685453160700683
"1439","mem",34584,28,11,39.3,107,29,6,20.7,1,-1,5,18.6,0.308411214953271,0.197802197802198,0.110609017151073
"1440","mem",34596,34,9,26.5,95,42,16,38.1,0,-8,-7,-11.6,0.284210526315789,0.403361344537815,-0.119150818222026
"1441","mem",34625,22,10,45.4,101,34,10,29.4,1,-12,0,16,0.297029702970297,0.303030303030303,-0.00600060006000602
"1442","mem",34643,26,9,34.6,109,35,16,45.7,0,-9,-7,-11.1,0.247706422018349,0.428571428571429,-0.18086500655308
"1443","mem",34648,26,11,42.3,102,25,10,40,1,1,1,2.3,0.323529411764706,0.315789473684211,0.00773993808049539
"1444","mem",34663,28,16,57.1,115,19,5,26.3,1,9,11,30.8,0.417391304347826,0.15625,0.261141304347826
"1445","mem",34677,30,14,46.7,119,25,9,36,1,5,5,10.7,0.352941176470588,0.272727272727273,0.0802139037433156
"1446","mem",34690,19,3,15.8,102,26,13,50,0,-7,-10,-34.2,0.0882352941176471,0.342105263157895,-0.253869969040248
"1447","mem",34703,28,10,35.7,107,26,10,38.5,1,2,0,-2.8,0.280373831775701,0.303030303030303,-0.0226564712546021
"1448","mem",34717,19,4,21,89,19,4,21,1,0,0,0,0.134831460674157,0.162162162162162,-0.0273307014880049
"1449","mem",34728,24,14,58.3,110,23,5,21.7,1,1,9,36.6,0.381818181818182,0.164835164835165,0.216983016983017
"1450","mem",34743,26,9,34.6,107,33,15,45.4,0,-7,-6,-10.8,0.252336448598131,0.368852459016393,-0.116516010418263
"1451","mem",34762,22,9,40.9,112,37,12,32.4,1,-15,-3,8.5,0.241071428571429,0.349514563106796,-0.108443134535368
"1452","mem",34780,33,6,18.2,91,18,8,44.4,0,15,-2,-26.2,0.197802197802198,0.252631578947368,-0.0548293811451706
"1453","mem",34797,27,9,33.3,92,26,11,42.3,0,1,-2,-9,0.293478260869565,0.323529411764706,-0.0300511508951407
"1454","mem",34816,33,11,33.3,105,34,11,32.4,1,-1,0,0.899999999999999,0.314285714285714,0.336734693877551,-0.0224489795918367
"1455","mem",34832,25,12,48,130,21,7,33.3,1,4,5,14.7,0.276923076923077,0.1875,0.0894230769230769
"1456","mem",34854,28,9,32.1,100,27,5,18.5,0,1,4,13.6,0.27,0.144230769230769,0.125769230769231
"1457","mem",34864,28,8,28.6,108,42,18,42.9,0,-14,-10,-14.3,0.222222222222222,0.439024390243902,-0.21680216802168
"1458","mem",34879,25,10,40,109,30,14,46.7,0,-5,-4,-6.7,0.275229357798165,0.344262295081967,-0.0690329372838021
"1459","mem",34901,20,7,35,98,30,11,36.7,0,-10,-4,-1.7,0.214285714285714,0.289473684210526,-0.0751879699248121
"1460","mem",34921,29,5,17.2,90,30,15,50,0,-1,-10,-32.8,0.166666666666667,0.420560747663551,-0.253894080996885
"1461","mem",34933,27,14,51.8,113,26,14,53.8,1,1,0,-2,0.371681415929204,0.451612903225806,-0.0799314872966029
"1462","mem",34949,31,11,35.5,98,28,11,39.3,1,3,0,-3.8,0.336734693877551,0.362637362637363,-0.0259026687598116
"1463","mem",34957,28,10,35.7,103,27,8,29.6,1,1,2,6.1,0.29126213592233,0.263736263736264,0.0275258721860663
"1464","mem",34973,30,13,43.3,104,28,9,32.1,1,2,4,11.2,0.375,0.28125,0.09375
"1465","mem",34994,35,9,25.7,82,29,9,31,0,6,0,-5.3,0.329268292682927,0.284210526315789,0.0450577663671374
"1466","mem",35010,29,10,34.5,90,26,8,30.8,0,3,2,3.7,0.333333333333333,0.247422680412371,0.0859106529209622
"1467","mem",35034,29,8,27.6,94,31,17,54.8,0,-2,-9,-27.2,0.25531914893617,0.481132075471698,-0.225812926535528
"1468","mem",35041,26,5,19.2,90,25,6,24,0,1,-1,-4.8,0.166666666666667,0.197802197802198,-0.0311355311355311
"1469","mem",35056,32,12,37.5,110,25,10,40,1,7,2,-2.5,0.327272727272727,0.309278350515464,0.0179943767572633
"1470","mem",35071,27,11,40.7,99,34,12,35.3,1,-7,-1,5.40000000000001,0.333333333333333,0.4,-0.0666666666666667
"1471","mem",35084,30,13,43.3,103,19,7,36.8,0,11,6,6.5,0.378640776699029,0.194444444444444,0.184196332254585
"1472","mem",35101,25,8,32,89,21,11,52.4,0,4,-3,-20.4,0.269662921348315,0.347368421052632,-0.077705499704317
"1473","mem",35107,26,9,34.6,100,31,14,45.2,0,-5,-5,-10.6,0.27,0.407766990291262,-0.137766990291262
"1474","mem",35121,27,15,55.6,101,28,6,21.4,1,-1,9,34.2,0.445544554455446,0.204545454545455,0.240999099909991
"1475","mem",35141,21,9,42.9,90,28,14,50,0,-7,-5,-7.1,0.3,0.407766990291262,-0.107766990291262
"1476","mem",35163,25,8,32,93,34,9,26.5,0,-9,-1,5.5,0.258064516129032,0.27,-0.0119354838709678
"1477","nop",33950,19,3,15.8,102,24,8,33.3,0,-5,-5,-17.5,0.0882352941176471,0.224299065420561,-0.136063771302914
"1478","nop",33965,22,5,22.7,114,28,9,32.1,0,-6,-4,-9.4,0.131578947368421,0.221311475409836,-0.089732528041415
"1479","nop",33972,22,4,18.2,79,24,10,41.7,0,-2,-6,-23.5,0.151898734177215,0.306122448979592,-0.154223714802377
"1480","nop",33991,26,9,34.6,113,32,10,31.2,0,-6,-1,3.4,0.238938053097345,0.256410256410256,-0.0174722033129112
"1481","nop",34000,34,11,32.4,83,27,8,29.6,0,7,3,2.8,0.397590361445783,0.269662921348315,0.127927440097469
"1482","nop",34015,30,10,33.3,111,24,8,33.3,0,6,2,0,0.27027027027027,0.214285714285714,0.055984555984556
"1483","nop",34039,21,7,33.3,106,35,16,45.7,0,-14,-9,-12.4,0.19811320754717,0.413793103448276,-0.215679895901106
"1484","nop",34045,21,5,23.8,94,25,8,32,0,-4,-3,-8.2,0.159574468085106,0.235294117647059,-0.0757196495619524
"1485","nop",34057,25,9,36,112,18,6,33.3,1,7,3,2.7,0.241071428571429,0.169811320754717,0.0712601078167116
"1486","nop",34069,20,6,30,99,30,16,53.3,0,-10,-10,-23.3,0.181818181818182,0.380952380952381,-0.199134199134199
"1487","nop",34088,21,6,28.6,106,41,12,29.3,1,-20,-6,-0.699999999999999,0.169811320754717,0.342857142857143,-0.173045822102426
"1488","nop",34099,21,7,33.3,82,27,10,37,0,-6,-3,-3.7,0.25609756097561,0.337078651685393,-0.0809810907097835
"1489","nop",34117,24,9,37.5,113,34,12,35.3,1,-10,-3,2.2,0.238938053097345,0.356435643564356,-0.117497590467011
"1490","nop",34125,36,14,38.9,121,43,15,34.9,1,-7,-1,4,0.347107438016529,0.387931034482759,-0.0408235964662297
"1491","nop",34149,25,11,44,112,29,10,34.5,1,-4,1,9.5,0.294642857142857,0.319148936170213,-0.0245060790273556
"1492","nop",34162,24,9,37.5,117,17,3,17.6,1,7,6,19.9,0.230769230769231,0.09375,0.137019230769231
"1493","nop",34177,23,13,56.5,104,32,12,37.5,0,-9,1,19,0.375,0.302521008403361,0.0724789915966387
"1494","nop",34190,20,5,25,81,27,10,37,0,-7,-5,-12,0.185185185185185,0.32967032967033,-0.144485144485144
"1495","nop",34203,31,8,25.8,105,30,5,16.7,1,1,3,9.1,0.228571428571429,0.170454545454545,0.0581168831168831
"1496","nop",34227,20,5,25,96,24,10,41.7,0,-4,-5,-16.7,0.15625,0.263157894736842,-0.106907894736842
"1497","nop",34241,28,6,21.4,92,28,6,21.4,0,0,0,0,0.195652173913043,0.178217821782178,0.0174343521308653
"1498","nop",34250,32,10,31.2,108,34,13,38.2,0,-2,-3,-7,0.277777777777778,0.354545454545455,-0.0767676767676768
"1499","nop",34274,25,7,28,88,40,12,30,0,-15,-5,-2,0.238636363636364,0.363636363636364,-0.125
"1500","nop",34295,19,8,42.1,105,36,17,47.2,0,-17,-9,-5.1,0.228571428571429,0.383458646616541,-0.154887218045113
"1501","nop",34299,40,16,40,120,41,14,34.2,1,-1,2,5.8,0.4,0.352941176470588,0.0470588235294118
"1502","nop",34311,35,14,40,109,34,14,41.2,0,1,0,-1.2,0.385321100917431,0.371681415929204,0.0136396849882277
"1503","nop",34325,27,10,37,102,21,3,14.3,1,6,7,22.7,0.294117647058824,0.0947368421052632,0.19938080495356
"1504","nop",34335,27,9,33.3,100,61,24,39.3,0,-34,-15,-6,0.27,0.590163934426229,-0.320163934426229
"1505","nop",34352,26,10,38.5,100,22,11,50,0,4,-1,-11.5,0.3,0.292035398230089,0.00796460176991148
"1506","nop",34358,17,10,58.8,108,33,11,33.3,1,-16,-1,25.5,0.277777777777778,0.354838709677419,-0.0770609318996416
"1507","nop",34373,20,8,40,110,28,11,39.3,0,-8,-3,0.700000000000003,0.218181818181818,0.272727272727273,-0.0545454545454545
"1508","nop",34389,28,11,39.3,91,20,8,40,1,8,3,-0.700000000000003,0.362637362637363,0.275862068965517,0.0867752936718454
"1509","nop",34406,25,12,48,111,32,13,40.6,1,-7,-1,7.4,0.324324324324324,0.375,-0.0506756756756757
"1510","nop",34435,29,12,41.4,104,23,7,30.4,1,6,5,11,0.346153846153846,0.228260869565217,0.117892976588629
"1511","nop",34454,26,11,42.3,82,31,6,19.4,0,-5,5,22.9,0.402439024390244,0.2,0.202439024390244
"1512","nop",34479,35,15,42.9,94,23,9,39.1,0,12,6,3.8,0.478723404255319,0.272727272727273,0.205996131528046
"1513","nop",34493,31,10,32.3,108,36,18,50,0,-5,-8,-17.7,0.277777777777778,0.461538461538462,-0.183760683760684
"1514","nop",34508,27,12,44.4,110,29,11,37.9,1,-2,1,6.5,0.327272727272727,0.34375,-0.0164772727272727
"1515","nop",34527,32,11,34.4,104,42,9,21.4,1,-10,2,13,0.317307692307692,0.284210526315789,0.0330971659919028
"1516","nop",34542,23,7,30.4,99,20,8,40,0,3,-1,-9.6,0.212121212121212,0.224299065420561,-0.0121778532993486
"1517","nop",34556,25,10,40,95,19,5,26.3,0,6,5,13.7,0.315789473684211,0.153061224489796,0.162728249194415
"1518","nop",34571,36,15,41.7,118,32,11,34.4,1,4,4,7.3,0.38135593220339,0.336734693877551,0.0446212383258388
"1519","nop",34585,34,11,32.4,114,30,15,50,0,4,-4,-17.6,0.289473684210526,0.314685314685315,-0.0252116304747884
"1520","nop",34611,39,16,41,124,37,15,40.5,1,2,1,0.5,0.387096774193548,0.368852459016393,0.0182443151771549
"1521","nop",34626,27,11,40.7,105,27,10,37,0,0,1,3.7,0.314285714285714,0.263157894736842,0.0511278195488722
"1522","nop",34641,30,13,43.3,119,28,12,42.9,1,2,1,0.399999999999999,0.327731092436975,0.349514563106796,-0.0217834706698213
"1523","nop",34654,32,10,31.2,94,21,10,47.6,0,11,0,-16.4,0.319148936170213,0.280373831775701,0.0387751043945119
"1524","nop",34665,30,12,40,106,31,10,32.3,0,-1,2,7.7,0.339622641509434,0.277777777777778,0.0618448637316562
"1525","nop",34675,21,5,23.8,98,26,10,38.5,0,-5,-5,-14.7,0.153061224489796,0.254237288135593,-0.101176063645797
"1526","nop",34695,17,5,29.4,91,31,10,32.3,0,-14,-5,-2.9,0.164835164835165,0.285714285714286,-0.120879120879121
"1527","nop",34714,26,9,34.6,111,27,5,18.5,1,-1,4,16.1,0.243243243243243,0.141509433962264,0.101733809280979
"1528","nop",34729,24,5,20.8,94,32,14,43.8,0,-8,-9,-23,0.159574468085106,0.330708661417323,-0.171134193332216
"1529","nop",34744,25,12,48,122,27,6,22.2,1,-2,6,25.8,0.295081967213115,0.169811320754717,0.125270646458398
"1530","nop",34759,31,13,41.9,99,31,11,35.5,0,0,2,6.4,0.393939393939394,0.314285714285714,0.0796536796536796
"1531","nop",34769,28,8,28.6,110,23,8,34.8,1,5,0,-6.2,0.218181818181818,0.222222222222222,-0.00404040404040404
"1532","nop",34780,18,8,44.4,95,33,6,18.2,1,-15,2,26.2,0.252631578947368,0.197802197802198,0.0548293811451706
"1533","nop",34792,31,6,19.4,99,51,20,39.2,0,-20,-14,-19.8,0.181818181818182,0.465116279069767,-0.283298097251586
"1534","nop",34810,24,5,20.8,83,26,12,46.2,0,-2,-7,-25.4,0.180722891566265,0.375,-0.194277108433735
"1535","nop",34820,21,8,38.1,110,21,6,28.6,0,0,2,9.5,0.218181818181818,0.152542372881356,0.0656394453004622
"1536","nop",34841,25,9,36,109,23,3,13,1,2,6,23,0.247706422018349,0.104651162790698,0.143055259227651
"1537","nop",34857,25,8,32,98,27,6,22.2,0,-2,2,9.8,0.244897959183673,0.178217821782178,0.0666801374014953
"1538","nop",34873,24,9,37.5,105,28,10,35.7,1,-4,-1,1.8,0.257142857142857,0.309278350515464,-0.0521354933726068
"1539","nop",34884,33,10,30.3,83,27,10,37,0,6,0,-6.7,0.36144578313253,0.340909090909091,0.0205366922234392
"1540","nop",34893,29,9,31,87,21,8,38.1,0,8,1,-7.1,0.310344827586207,0.25531914893617,0.0550256786500367
"1541","nop",34916,34,14,41.2,125,46,13,28.3,1,-12,1,12.9,0.336,0.319672131147541,0.016327868852459
"1542","nop",34942,21,6,28.6,100,32,11,34.4,1,-11,-5,-5.8,0.18,0.428571428571429,-0.248571428571429
"1543","nop",34947,22,9,40.9,112,35,16,45.7,0,-13,-7,-4.8,0.241071428571429,0.4,-0.158928571428571
"1544","nop",34964,34,12,35.3,128,40,13,32.5,1,-6,-1,2.8,0.28125,0.348214285714286,-0.0669642857142857
"1545","nop",34979,30,14,46.7,123,25,9,36,1,5,5,10.7,0.341463414634146,0.247706422018349,0.0937569926157977
"1546","nop",34994,29,9,31,95,35,9,25.7,1,-6,0,5.3,0.284210526315789,0.329268292682927,-0.0450577663671374
"1547","nop",35019,38,14,36.8,107,39,14,35.9,0,-1,0,0.899999999999999,0.392523364485981,0.358974358974359,0.0335490055116223
"1548","nop",35035,27,9,33.3,115,25,6,24,1,2,3,9.3,0.234782608695652,0.2,0.0347826086956522
"1549","nop",35042,25,10,40,100,27,15,55.6,0,-2,-5,-15.6,0.3,0.416666666666667,-0.116666666666667
"1550","nop",35057,30,12,40,121,27,14,51.8,1,3,-2,-11.8,0.297520661157025,0.355932203389831,-0.0584115422328057
"1551","nop",35072,33,10,30.3,117,19,6,31.6,1,14,4,-1.3,0.256410256410256,0.202247191011236,0.0541630653990204
"1552","nop",35087,30,10,33.3,110,26,13,50,0,4,-3,-16.7,0.272727272727273,0.333333333333333,-0.0606060606060606
"1553","nop",35098,32,14,43.8,131,30,13,43.3,0,2,1,0.5,0.320610687022901,0.291044776119403,0.0295659109034977
"1554","nop",35124,23,3,13,106,32,13,40.6,0,-9,-10,-27.6,0.0849056603773585,0.319672131147541,-0.234766470770183
"1555","nop",35135,21,5,23.8,101,33,10,30.3,0,-12,-5,-6.5,0.148514851485149,0.24390243902439,-0.0953875875392417
"1556","nop",35155,22,7,31.8,96,22,8,36.4,0,0,-1,-4.6,0.21875,0.222222222222222,-0.00347222222222221
"1557","nop",35170,24,8,33.3,103,30,13,43.3,1,-6,-5,-10,0.233009708737864,0.39,-0.156990291262136
"1558","nop",40246,29,10,34.5,102,37,11,29.7,1,-8,-1,4.8,0.294117647058824,0.336734693877551,-0.0426170468187275
"1559","sas",33943,24,12,50,129,33,7,21.2,1,-9,5,28.8,0.27906976744186,0.21,0.0690697674418605
"1560","sas",33956,18,6,33.3,102,20,6,30,1,-2,0,3.3,0.176470588235294,0.191489361702128,-0.0150187734668335
"1561","sas",33972,24,10,41.7,98,22,4,18.2,1,2,6,23.5,0.306122448979592,0.151898734177215,0.154223714802377
"1562","sas",33977,18,10,55.6,106,20,7,35,1,-2,3,20.6,0.283018867924528,0.212121212121212,0.0708976558033162
"1563","sas",33993,20,6,30,91,31,15,48.4,0,-11,-9,-18.4,0.197802197802198,0.424528301886792,-0.226726104084595
"1564","sas",34017,20,6,30,100,26,11,42.3,1,-6,-5,-12.3,0.18,0.383720930232558,-0.203720930232558
"1565","sas",34026,25,10,40,92,23,9,39.1,0,2,1,0.899999999999999,0.326086956521739,0.232758620689655,0.093328335832084
"1566","sas",34054,23,7,30.4,99,30,10,33.3,0,-7,-3,-2.9,0.212121212121212,0.297029702970297,-0.0849084908490849
"1567","sas",34067,20,9,45,96,25,5,20,1,-5,4,25,0.28125,0.174418604651163,0.106831395348837
"1568","sas",34074,18,5,27.8,106,47,15,31.9,1,-29,-10,-4.1,0.141509433962264,0.45,-0.308490566037736
"1569","sas",34090,15,8,53.3,94,15,4,26.7,1,0,4,26.6,0.25531914893617,0.133333333333333,0.121985815602837
"1570","sas",34108,30,11,36.7,110,20,9,45,1,10,2,-8.3,0.3,0.257142857142857,0.0428571428571429
"1571","sas",34122,24,10,41.7,116,25,12,48,1,-1,-2,-6.3,0.258620689655172,0.336448598130841,-0.0778279084756687
"1572","sas",34146,20,8,40,96,27,8,29.6,1,-7,0,10.4,0.25,0.263736263736264,-0.0137362637362637
"1573","sas",34153,31,13,41.9,119,20,11,55,1,11,2,-13.1,0.327731092436975,0.289473684210526,0.0382574082264485
"1574","sas",34165,24,11,45.8,109,34,12,35.3,1,-10,-1,10.5,0.302752293577982,0.349514563106796,-0.0467622695288145
"1575","sas",34180,24,9,37.5,112,22,6,27.3,1,2,3,10.2,0.241071428571429,0.18,0.0610714285714286
"1576","sas",34204,20,5,25,83,15,6,40,0,5,-1,-15,0.180722891566265,0.189473684210526,-0.00875079264426126
"1577","sas",34212,19,11,57.9,94,30,10,33.3,1,-11,1,24.6,0.351063829787234,0.344827586206897,0.00623624358033747
"1578","sas",34229,20,8,40,107,11,7,63.6,1,9,1,-23.6,0.224299065420561,0.2,0.0242990654205607
"1579","sas",34249,28,8,28.6,97,24,6,25,1,4,2,3.6,0.247422680412371,0.1875,0.0599226804123711
"1580","sas",34259,24,11,45.8,105,20,7,35,1,4,4,10.8,0.314285714285714,0.230769230769231,0.0835164835164835
"1581","sas",34276,28,9,32.1,91,17,4,23.5,0,11,5,8.6,0.296703296703297,0.126315789473684,0.170387507229612
"1582","sas",34293,26,14,53.8,130,27,7,25.9,1,-1,7,27.9,0.323076923076923,0.207920792079208,0.115156130997715
"1583","sas",34323,22,8,36.4,108,31,10,32.3,1,-9,-2,4.1,0.222222222222222,0.297029702970297,-0.0748074807480748
"1584","sas",34352,22,11,50,113,26,10,38.5,1,-4,1,11.5,0.292035398230089,0.3,-0.00796460176991148
"1585","sas",34365,23,12,52.2,102,38,6,15.8,1,-15,6,36.4,0.352941176470588,0.18,0.172941176470588
"1586","sas",34381,19,6,31.6,101,28,11,39.3,0,-9,-5,-7.7,0.178217821782178,0.311320754716981,-0.133102932934803
"1587","sas",34394,20,12,60,110,30,12,40,1,-10,0,20,0.327272727272727,0.4,-0.0727272727272728
"1588","sas",34398,18,9,50,119,18,7,38.9,1,0,2,11.1,0.226890756302521,0.21,0.016890756302521
"1589","sas",34422,17,5,29.4,119,16,7,43.8,1,1,-2,-14.4,0.126050420168067,0.214285714285714,-0.0882352941176471
"1590","sas",34439,22,11,50,110,20,6,30,1,2,5,20,0.3,0.191489361702128,0.108510638297872
"1591","sas",34448,27,9,33.3,112,28,14,50,0,-1,-5,-16.7,0.241071428571429,0.368421052631579,-0.12734962406015
"1592","sas",34465,24,13,54.2,110,18,4,22.2,1,6,9,32,0.354545454545455,0.146341463414634,0.20820399113082
"1593","sas",34483,24,12,50,127,25,7,28,1,-1,5,22,0.283464566929134,0.212121212121212,0.0713433548079217
"1594","sas",34498,34,13,38.2,102,21,4,19,1,13,9,19.2,0.382352941176471,0.141176470588235,0.241176470588235
"1595","sas",34515,30,12,40,107,19,10,52.6,0,11,2,-12.6,0.336448598130841,0.275229357798165,0.061219240332676
"1596","sas",34529,21,10,47.6,134,19,6,31.6,1,2,4,16,0.223880597014925,0.191489361702128,0.0323912353127977
"1597","sas",34543,20,9,45,105,21,8,38.1,0,-1,1,6.9,0.257142857142857,0.222222222222222,0.0349206349206349
"1598","sas",34565,18,8,44.4,122,13,6,46.2,1,5,2,-1.8,0.19672131147541,0.157894736842105,0.0388265746333046
"1599","sas",34579,22,9,40.9,118,31,10,32.3,1,-9,-1,8.6,0.228813559322034,0.288461538461538,-0.0596479791395045
"1600","sas",34597,26,10,38.5,118,34,13,38.2,1,-8,-3,0.299999999999997,0.254237288135593,0.339130434782609,-0.0848931466470155
"1601","sas",34606,22,9,40.9,112,25,5,20,1,-3,4,20.9,0.241071428571429,0.174418604651163,0.0666528239202658
"1602","sas",34614,24,7,29.2,108,25,6,24,1,-1,1,5.2,0.194444444444444,0.169811320754717,0.0246331236897275
"1603","sas",34641,28,12,42.9,103,30,13,43.3,0,-2,-1,-0.399999999999999,0.349514563106796,0.327731092436975,0.0217834706698213
"1604","sas",34657,22,8,36.4,101,34,12,35.3,0,-12,-4,1.1,0.237623762376238,0.342857142857143,-0.105233380480905
"1605","sas",34667,21,7,33.3,108,28,7,25,1,-7,0,8.3,0.194444444444444,0.223404255319149,-0.0289598108747045
"1606","sas",34684,21,6,28.6,102,25,9,36,1,-4,-3,-7.4,0.176470588235294,0.313953488372093,-0.137482900136799
"1607","sas",34702,21,10,47.6,121,26,10,38.5,1,-5,0,9.1,0.247933884297521,0.309278350515464,-0.0613444662179433
"1608","sas",34717,19,4,21,74,19,4,21,0,0,0,0,0.162162162162162,0.134831460674157,0.0273307014880049
"1609","sas",34722,22,11,50,111,34,13,38.2,1,-12,-2,11.8,0.297297297297297,0.378640776699029,-0.0813434794017318
"1610","sas",34741,19,9,47.4,103,17,5,29.4,1,2,4,18,0.262135922330097,0.16304347826087,0.0990924440692275
"1611","sas",34757,29,6,20.7,90,14,9,64.3,0,15,-3,-43.6,0.2,0.287234042553192,-0.0872340425531915
"1612","sas",34765,15,7,46.7,110,20,9,45,1,-5,-2,1.7,0.190909090909091,0.254716981132075,-0.0638078902229846
"1613","sas",34774,31,8,25.8,107,18,4,22.2,1,13,4,3.6,0.224299065420561,0.151898734177215,0.0724003312433456
"1614","sas",34805,26,9,34.6,105,23,7,30.4,1,3,2,4.2,0.257142857142857,0.216494845360825,0.0406480117820324
"1615","sas",34814,21,10,47.6,119,22,7,31.8,1,-1,3,15.8,0.252100840336134,0.214285714285714,0.0378151260504202
"1616","sas",34842,29,9,31,100,24,7,29.2,1,5,2,1.8,0.27,0.212121212121212,0.0578787878787879
"1617","sas",34857,27,6,22.2,101,25,8,32,1,2,-2,-9.8,0.178217821782178,0.244897959183673,-0.0666801374014953
"1618","sas",34865,24,6,25,97,16,4,25,1,8,2,0,0.185567010309278,0.133333333333333,0.052233676975945
"1619","sas",34882,27,11,40.7,112,39,14,35.9,1,-12,-3,4.8,0.294642857142857,0.381818181818182,-0.0871753246753247
"1620","sas",34897,29,14,48.3,114,19,7,36.8,1,10,7,11.5,0.368421052631579,0.201923076923077,0.166497975708502
"1621","sas",34902,19,6,31.6,92,20,6,30,0,-1,0,1.6,0.195652173913043,0.176470588235294,0.0191815856777494
"1622","sas",34920,27,12,44.4,107,17,5,29.4,1,10,7,15,0.336448598130841,0.176470588235294,0.159978009895547
"1623","sas",34934,34,16,47.1,107,22,6,27.3,1,12,10,19.8,0.448598130841121,0.181818181818182,0.26677994902294
"1624","sas",34951,26,11,42.3,106,22,9,40.9,0,4,2,1.4,0.311320754716981,0.245454545454545,0.0658662092624357
"1625","sas",34973,28,9,32.1,96,30,13,43.3,0,-2,-4,-11.2,0.28125,0.375,-0.09375
"1626","sas",34982,28,11,39.3,118,10,7,70,1,18,4,-30.7,0.279661016949153,0.205882352941176,0.0737786640079761
"1627","sas",34996,24,8,33.3,100,15,7,46.7,1,9,1,-13.4,0.24,0.225806451612903,0.0141935483870968
"1628","sas",35010,26,8,30.8,97,29,10,34.5,1,-3,-2,-3.7,0.247422680412371,0.333333333333333,-0.0859106529209622
"1629","sas",35025,25,10,40,106,10,3,30,1,15,7,10,0.283018867924528,0.0918367346938776,0.191182133230651
"1630","sas",35039,26,7,26.9,103,26,4,15.4,1,0,3,11.5,0.203883495145631,0.162162162162162,0.0417213329834689
"1631","sas",35058,24,9,37.5,98,26,13,50,0,-2,-4,-12.5,0.275510204081633,0.354545454545455,-0.0790352504638219
"1632","sas",35075,27,9,33.3,100,21,6,28.6,1,6,3,4.7,0.27,0.189473684210526,0.0805263157894737
"1633","sas",35086,19,10,52.6,109,24,9,37.5,1,-5,1,15.1,0.275229357798165,0.262135922330097,0.0130934354680681
"1634","sas",35101,21,11,52.4,95,25,8,32,1,-4,3,20.4,0.347368421052632,0.269662921348315,0.077705499704317
"1635","sas",35110,35,13,37.1,95,14,7,50,0,21,6,-12.9,0.410526315789474,0.205882352941176,0.204643962848297
"1636","sas",35123,28,9,32.1,102,27,8,29.6,1,1,1,2.5,0.264705882352941,0.269662921348315,-0.00495703899537342
"1637","sas",35133,22,8,36.4,87,22,6,27.3,0,0,2,9.1,0.275862068965517,0.183673469387755,0.0921885995777621
"1638","sas",35149,21,8,38.1,98,28,12,42.9,0,-7,-4,-4.8,0.244897959183673,0.363636363636364,-0.11873840445269
"1639","sas",35167,21,8,38.1,97,26,10,38.5,0,-5,-2,-0.399999999999999,0.247422680412371,0.297029702970297,-0.0496070225579259
"1640","sas",40235,16,5,31.2,107,27,10,37,1,-11,-5,-5.8,0.14018691588785,0.326086956521739,-0.185900040633889
"1641","atl",33954,26,12,46.2,114,20,6,30,1,6,6,16.2,0.315789473684211,0.181818181818182,0.133971291866029
"1642","atl",33966,20,5,25,104,18,5,27.8,1,2,0,-2.8,0.144230769230769,0.208333333333333,-0.0641025641025641
"1643","atl",33984,30,11,36.7,106,23,10,43.5,1,7,1,-6.8,0.311320754716981,0.315789473684211,-0.00446871896722939
"1644","atl",33999,32,11,34.4,116,22,9,40.9,0,10,2,-6.5,0.28448275862069,0.219512195121951,0.0649705634987384
"1645","atl",34010,25,5,20,92,20,5,25,0,5,0,-5,0.16304347826087,0.157894736842105,0.00514874141876431
"1646","atl",34024,20,8,40,112,36,12,33.3,1,-16,-4,6.7,0.214285714285714,0.371134020618557,-0.156848306332842
"1647","atl",34040,29,11,37.9,110,42,11,26.2,1,-13,0,11.7,0.3,0.311320754716981,-0.0113207547169811
"1648","atl",34051,20,9,45,115,27,9,33.3,1,-7,0,11.7,0.234782608695652,0.252336448598131,-0.0175538399024786
"1649","atl",34072,32,13,40.6,117,29,11,37.9,1,3,2,2.7,0.333333333333333,0.34375,-0.0104166666666667
"1650","atl",34094,17,6,35.3,93,23,7,30.4,1,-6,-1,4.9,0.193548387096774,0.233333333333333,-0.0397849462365591
"1651","atl",34103,32,10,31.2,107,32,8,25,1,0,2,6.2,0.280373831775701,0.24,0.0403738317757009
"1652","atl",34114,28,7,25,96,29,10,34.5,0,-1,-3,-9.5,0.21875,0.3,-0.08125
"1653","atl",34133,21,6,28.6,94,27,10,37,0,-6,-4,-8.4,0.191489361702128,0.288461538461538,-0.0969721767594108
"1654","atl",34149,29,10,34.5,94,25,11,44,0,4,-1,-9.5,0.319148936170213,0.294642857142857,0.0245060790273556
"1655","atl",34156,20,5,25,96,27,7,25.9,1,-7,-2,-0.899999999999999,0.15625,0.247058823529412,-0.0908088235294118
"1656","atl",34171,25,8,32,68,34,10,29.4,0,-9,-2,2.6,0.352941176470588,0.315789473684211,0.0371517027863777
"1657","atl",34192,35,12,34.3,94,20,8,40,0,15,4,-5.7,0.382978723404255,0.220183486238532,0.162795237165723
"1658","atl",34199,29,7,24.1,100,35,12,34.3,0,-6,-5,-10.2,0.21,0.342857142857143,-0.132857142857143
"1659","atl",34214,25,9,36,107,21,10,47.6,0,4,-1,-11.6,0.252336448598131,0.275229357798165,-0.0228929092000343
"1660","atl",34228,24,6,25,85,29,17,58.6,0,-5,-11,-33.6,0.211764705882353,0.421487603305785,-0.209722897423432
"1661","atl",34233,28,7,25,84,24,13,54.2,0,4,-6,-29.2,0.25,0.3046875,-0.0546875
"1662","atl",34247,22,7,31.8,99,31,10,32.3,0,-9,-3,-0.499999999999996,0.212121212121212,0.294117647058824,-0.0819964349376114
"1663","atl",34264,19,4,21,103,27,11,40.7,1,-8,-7,-19.7,0.116504854368932,0.347368421052632,-0.2308635666837
"1664","atl",34280,34,12,35.3,114,28,12,42.9,1,6,0,-7.6,0.315789473684211,0.327272727272727,-0.0114832535885168
"1665","atl",34309,28,11,39.3,120,34,15,44.1,0,-6,-4,-4.8,0.275,0.343511450381679,-0.0685114503816794
"1666","atl",34332,25,11,44,125,21,10,47.6,1,4,1,-3.6,0.264,0.247933884297521,0.0160661157024793
"1667","atl",34341,26,10,38.5,99,27,12,44.4,0,-1,-2,-5.9,0.303030303030303,0.336448598130841,-0.0334182951005381
"1668","atl",34355,23,9,39.1,110,35,10,28.6,1,-12,-1,10.5,0.245454545454545,0.277777777777778,-0.0323232323232323
"1669","atl",34370,26,7,26.9,84,29,9,31,0,-3,-2,-4.1,0.25,0.293478260869565,-0.0434782608695652
"1670","atl",34391,25,8,32,109,25,8,32,1,0,0,0,0.220183486238532,0.222222222222222,-0.00203873598369009
"1671","atl",34408,32,8,25,90,31,15,48.4,0,1,-7,-23.4,0.266666666666667,0.432692307692308,-0.166025641025641
"1672","atl",34418,27,7,25.9,102,27,7,25.9,1,0,0,0,0.205882352941176,0.214285714285714,-0.00840336134453781
"1673","atl",34438,26,8,30.8,105,31,9,29,1,-5,-1,1.8,0.228571428571429,0.275510204081633,-0.0469387755102041
"1674","atl",34448,28,14,50,114,27,9,33.3,1,1,5,16.7,0.368421052631579,0.241071428571429,0.12734962406015
"1675","atl",34470,19,10,52.6,111,28,9,32.1,1,-9,1,20.5,0.27027027027027,0.293478260869565,-0.023207990599295
"1676","atl",34479,23,9,39.1,99,35,15,42.9,1,-12,-6,-3.8,0.272727272727273,0.478723404255319,-0.205996131528046
"1677","atl",34497,22,11,50,97,36,9,25,1,-14,2,25,0.34020618556701,0.329268292682927,0.0109378928840835
"1678","atl",34513,23,7,30.4,117,29,10,34.5,1,-6,-3,-4.1,0.179487179487179,0.309278350515464,-0.129791171028284
"1679","atl",34537,29,11,37.9,101,44,17,38.6,0,-15,-6,-0.700000000000003,0.326732673267327,0.495145631067961,-0.168412957800634
"1680","atl",34547,26,13,50,111,19,6,31.6,1,7,7,18.4,0.351351351351351,0.183673469387755,0.167677881963596
"1681","atl",34553,32,12,37.5,108,26,8,30.8,1,6,4,6.7,0.333333333333333,0.224299065420561,0.109034267912773
"1682","atl",34573,25,6,24,95,25,10,40,0,0,-4,-16,0.189473684210526,0.254237288135593,-0.0647636039250669
"1683","atl",34587,22,9,40.9,102,28,7,25,1,-6,2,15.9,0.264705882352941,0.225806451612903,0.038899430740038
"1684","atl",34593,20,7,35,110,29,12,41.4,1,-9,-5,-6.4,0.190909090909091,0.387096774193548,-0.196187683284457
"1685","atl",34607,29,9,31,105,24,14,58.3,0,5,-5,-27.3,0.257142857142857,0.365217391304348,-0.108074534161491
"1686","atl",34623,30,17,56.7,119,27,8,29.6,1,3,9,27.1,0.428571428571429,0.210526315789474,0.218045112781955
"1687","atl",34642,31,9,29,86,31,13,41.9,0,0,-4,-12.9,0.313953488372093,0.348214285714286,-0.0342607973421927
"1688","atl",34651,31,10,32.3,142,51,18,35.3,1,-20,-8,-3,0.211267605633803,0.388489208633094,-0.177221602999291
"1689","atl",34674,26,7,26.9,93,32,12,37.5,0,-6,-5,-10.6,0.225806451612903,0.310344827586207,-0.0845383759733037
"1690","atl",34683,30,8,26.7,113,51,13,25.5,1,-21,-5,1.2,0.212389380530973,0.361111111111111,-0.148721730580138
"1691","atl",34696,28,10,35.7,113,27,7,25.9,1,1,3,9.8,0.265486725663717,0.244186046511628,0.0213006791520889
"1692","atl",34712,17,6,35.3,95,26,10,38.5,0,-9,-4,-3.2,0.189473684210526,0.25,-0.0605263157894737
"1693","atl",34725,27,8,29.6,117,44,13,29.6,1,-17,-5,0,0.205128205128205,0.367924528301887,-0.162796323173682
"1694","atl",34747,30,11,36.7,107,36,18,50,0,-6,-7,-13.3,0.308411214953271,0.5,-0.191588785046729
"1695","atl",34770,28,8,28.6,109,42,16,38.1,1,-14,-8,-9.5,0.220183486238532,0.461538461538462,-0.241354975299929
"1696","atl",34786,26,7,26.9,84,37,14,37.8,0,-11,-7,-10.9,0.25,0.424242424242424,-0.174242424242424
"1697","atl",34803,20,6,30,90,37,17,46,0,-17,-11,-16,0.2,0.472222222222222,-0.272222222222222
"1698","atl",34807,25,8,32,86,27,8,29.6,0,-2,0,2.4,0.27906976744186,0.228571428571429,0.0504983388704319
"1699","atl",34825,25,6,24,114,34,10,29.4,1,-9,-4,-5.4,0.157894736842105,0.306122448979592,-0.148227712137487
"1700","atl",34837,21,10,47.6,100,33,14,42.4,1,-12,-4,5.2,0.3,0.442105263157895,-0.142105263157895
"1701","atl",34853,26,10,38.5,130,46,25,54.4,0,-20,-15,-15.9,0.230769230769231,0.555555555555556,-0.324786324786325
"1702","atl",34867,27,9,33.3,96,33,15,45.4,0,-6,-6,-12.1,0.28125,0.463917525773196,-0.182667525773196
"1703","atl",34877,28,13,46.4,111,44,20,45.4,0,-16,-7,1,0.351351351351351,0.504201680672269,-0.152850329320918
"1704","atl",34890,20,4,20,110,34,11,32.4,1,-14,-7,-12.4,0.109090909090909,0.314285714285714,-0.205194805194805
"1705","atl",34909,22,8,36.4,105,25,4,16,1,-3,4,20.4,0.228571428571429,0.121212121212121,0.107359307359307
"1706","atl",34921,30,15,50,107,29,5,17.2,1,1,10,32.8,0.420560747663551,0.166666666666667,0.253894080996885
"1707","atl",34934,22,6,27.3,99,34,16,47.1,0,-12,-10,-19.8,0.181818181818182,0.448598130841121,-0.26677994902294
"1708","atl",34957,27,8,29.6,91,28,10,35.7,0,-1,-2,-6.1,0.263736263736264,0.29126213592233,-0.0275258721860663
"1709","atl",34969,26,7,26.9,97,18,8,44.4,0,8,-1,-17.5,0.216494845360825,0.212389380530973,0.0041054648298513
"1710","atl",34984,37,12,32.4,90,30,12,40,0,7,0,-7.6,0.4,0.342857142857143,0.0571428571428572
"1711","atl",35003,25,8,32,100,34,11,32.4,0,-9,-3,-0.399999999999999,0.24,0.317307692307692,-0.0773076923076923
"1712","atl",35018,22,8,36.4,97,27,8,29.6,0,-5,0,6.8,0.247422680412371,0.24,0.00742268041237115
"1713","atl",35028,27,5,18.5,92,22,6,27.3,0,5,-1,-8.8,0.16304347826087,0.168224299065421,-0.00518082080455098
"1714","atl",35046,27,6,22.2,95,31,7,22.6,1,-4,-1,-0.400000000000002,0.189473684210526,0.230769230769231,-0.0412955465587045
"1715","atl",35051,18,9,50,99,39,11,28.2,1,-21,-2,21.8,0.272727272727273,0.358695652173913,-0.0859683794466403
"1716","atl",35078,28,11,39.3,104,30,12,40,0,-2,-1,-0.700000000000003,0.317307692307692,0.339622641509434,-0.0223149492017417
"1717","atl",35089,24,7,29.2,82,33,10,30.3,0,-9,-3,-1.1,0.25609756097561,0.32967032967033,-0.0735727686947199
"1718","atl",35117,23,11,47.8,123,43,15,34.9,1,-20,-4,12.9,0.268292682926829,0.387931034482759,-0.119638351555929
"1719","atl",35119,37,16,43.2,114,36,9,25,1,1,7,18.2,0.421052631578947,0.27,0.151052631578947
"1720","atl",35137,31,9,29,126,46,19,41.3,1,-15,-10,-12.3,0.214285714285714,0.456,-0.241714285714286
"1721","atl",35152,27,7,25.9,103,23,3,13,1,4,4,12.9,0.203883495145631,0.118421052631579,0.0854624425140521
"1722","atl",35166,29,11,37.9,86,24,10,41.7,0,5,1,-3.8,0.383720930232558,0.288461538461538,0.0952593917710197
"1723","cha",33948,23,7,30.4,107,16,3,18.8,1,7,4,11.6,0.196261682242991,0.09375,0.102511682242991
"1724","cha",33962,22,7,31.8,97,34,14,41.2,1,-12,-7,-9.4,0.216494845360825,0.461538461538462,-0.245043616177637
"1725","cha",33967,32,9,28.1,98,31,15,48.4,0,1,-6,-20.3,0.275510204081633,0.432692307692308,-0.157182103610675
"1726","cha",33996,34,13,38.2,109,38,12,31.6,1,-4,1,6.6,0.357798165137615,0.387096774193548,-0.0292986090559337
"1727","cha",34012,30,10,33.3,99,36,9,25,1,-6,1,8.3,0.303030303030303,0.284210526315789,0.0188197767145136
"1728","cha",34035,32,12,37.5,122,33,9,27.3,1,-1,3,10.2,0.295081967213115,0.27,0.0250819672131147
"1729","cha",34048,26,8,30.8,104,34,8,23.5,1,-8,0,7.3,0.230769230769231,0.244897959183673,-0.0141287284144427
"1730","cha",34063,41,17,41.5,111,22,6,27.3,0,19,11,14.2,0.459459459459459,0.15929203539823,0.300167424061229
"1731","cha",34080,29,11,37.9,93,38,14,36.8,0,-9,-3,1.1,0.354838709677419,0.42,-0.0651612903225806
"1732","cha",34095,24,11,45.8,115,35,15,42.9,1,-11,-4,2.9,0.28695652173913,0.416666666666667,-0.129710144927536
"1733","cha",34114,29,10,34.5,100,28,7,25,1,1,3,9.5,0.3,0.21875,0.08125
"1734","cha",34125,43,15,34.9,116,36,14,38.9,0,7,1,-4,0.387931034482759,0.347107438016529,0.0408235964662297
"1735","cha",34141,31,9,29,90,26,12,46.2,0,5,-3,-17.2,0.3,0.342857142857143,-0.0428571428571429
"1736","cha",34153,20,11,55,114,31,13,41.9,0,-11,-2,13.1,0.289473684210526,0.327731092436975,-0.0382574082264485
"1737","cha",34168,29,8,27.6,111,28,11,39.3,0,1,-3,-11.7,0.216216216216216,0.292035398230089,-0.0758191820138723
"1738","cha",34181,22,8,36.4,107,32,12,37.5,1,-10,-4,-1.1,0.224299065420561,0.352941176470588,-0.128642111050028
"1739","cha",34197,26,9,34.6,104,29,7,24.1,1,-3,2,10.5,0.259615384615385,0.247058823529412,0.0125565610859729
"1740","cha",34200,27,9,33.3,89,28,12,42.9,0,-1,-3,-9.6,0.303370786516854,0.321428571428571,-0.0180577849117175
"1741","cha",34216,18,5,27.8,97,31,9,29,1,-13,-4,-1.2,0.154639175257732,0.310344827586207,-0.155705652328475
"1742","cha",34232,36,14,38.9,120,27,10,37,0,9,4,1.9,0.35,0.24,0.11
"1743","cha",34252,18,3,16.7,109,36,13,36.1,1,-18,-10,-19.4,0.0825688073394495,0.386138613861386,-0.303569806521937
"1744","cha",34261,21,6,28.6,87,27,4,14.8,1,-6,2,13.8,0.206896551724138,0.155844155844156,0.0510523958799821
"1745","cha",34277,22,9,40.9,109,34,9,26.5,1,-12,0,14.4,0.247706422018349,0.306818181818182,-0.0591117597998332
"1746","cha",34289,27,10,37,105,31,13,41.9,0,-4,-3,-4.9,0.285714285714286,0.336206896551724,-0.0504926108374384
"1747","cha",34301,26,10,38.5,94,36,17,47.2,0,-10,-7,-8.7,0.319148936170213,0.463636363636364,-0.144487427466151
"1748","cha",34315,33,14,42.4,106,18,5,27.8,0,15,9,14.6,0.39622641509434,0.137614678899083,0.258611736195257
"1749","cha",34331,30,8,26.7,88,28,9,32.1,0,2,-1,-5.4,0.272727272727273,0.28125,-0.00852272727272729
"1750","cha",34341,27,12,44.4,107,26,10,38.5,1,1,2,5.9,0.336448598130841,0.303030303030303,0.0334182951005381
"1751","cha",34359,25,11,44,117,33,16,48.5,1,-8,-5,-4.5,0.282051282051282,0.424778761061947,-0.142727479010665
"1752","cha",34382,18,5,27.8,103,22,7,31.8,1,-4,-2,-4,0.145631067961165,0.230769230769231,-0.0851381628080657
"1753","cha",34403,26,8,30.8,118,31,15,48.4,0,-5,-7,-17.6,0.203389830508475,0.375,-0.171610169491525
"1754","cha",34417,24,10,41.7,120,34,9,26.5,1,-10,1,15.2,0.25,0.267326732673267,-0.0173267326732673
"1755","cha",34426,26,5,19.2,91,28,10,35.7,1,-2,-5,-16.5,0.164835164835165,0.365853658536585,-0.201018493701421
"1756","cha",34444,24,9,37.5,109,31,14,45.2,0,-7,-5,-7.7,0.247706422018349,0.347107438016529,-0.0994010159981803
"1757","cha",34457,19,9,47.4,111,23,7,30.4,0,-4,2,17,0.243243243243243,0.177966101694915,0.065277141548328
"1758","cha",34469,24,9,37.5,123,30,9,30,1,-6,0,7.5,0.219512195121951,0.241071428571429,-0.0215592334494774
"1759","cha",34478,26,10,38.5,114,28,10,35.7,0,-2,0,2.8,0.263157894736842,0.260869565217391,0.00228832951945079
"1760","cha",34498,21,4,19,85,34,13,38.2,0,-13,-9,-19.2,0.141176470588235,0.382352941176471,-0.241176470588235
"1761","cha",34514,43,19,44.2,114,39,17,43.6,0,4,2,0.600000000000001,0.5,0.421487603305785,0.0785123966942149
"1762","cha",34532,23,6,26.1,93,38,14,36.8,0,-15,-8,-10.7,0.193548387096774,0.411764705882353,-0.218216318785579
"1763","cha",34558,25,8,32,98,39,15,38.5,0,-14,-7,-6.5,0.244897959183673,0.416666666666667,-0.171768707482993
"1764","cha",34569,26,11,42.3,107,31,8,25.8,1,-5,3,16.5,0.308411214953271,0.282352941176471,0.0260582737768004
"1765","cha",34582,25,12,48,113,30,7,23.3,1,-5,5,24.7,0.31858407079646,0.269230769230769,0.049353301565691
"1766","cha",34592,29,14,48.3,112,41,17,41.5,1,-12,-3,6.8,0.375,0.485714285714286,-0.110714285714286
"1767","cha",34605,32,8,25,99,25,10,40,0,7,-2,-15,0.242424242424242,0.275229357798165,-0.0328051153739227
"1768","cha",34627,23,7,30.4,103,28,11,39.3,0,-5,-4,-8.9,0.203883495145631,0.292035398230089,-0.0881519030844574
"1769","cha",34639,37,13,35.1,107,27,9,33.3,0,10,4,1.8,0.364485981308411,0.245454545454545,0.119031435853866
"1770","cha",34644,37,12,32.4,106,27,11,40.7,0,10,1,-8.3,0.339622641509434,0.302752293577982,0.0368703479314523
"1771","cha",34668,31,11,35.5,98,31,11,35.5,0,0,0,0,0.336734693877551,0.28695652173913,0.0497781721384206
"1772","cha",34681,30,9,30,111,48,21,43.8,0,-18,-12,-13.8,0.243243243243243,0.5,-0.256756756756757
"1773","cha",34700,33,13,39.4,98,33,13,39.4,0,0,0,0,0.397959183673469,0.371428571428571,0.0265306122448979
"1774","cha",34719,26,7,26.9,111,36,12,33.3,1,-10,-5,-6.4,0.189189189189189,0.336448598130841,-0.147259408941652
"1775","cha",34734,26,8,30.8,95,40,13,32.5,0,-14,-5,-1.7,0.252631578947368,0.364485981308411,-0.111854402361043
"1776","cha",34748,37,13,35.1,102,34,14,41.2,0,3,-1,-6.1,0.382352941176471,0.392523364485981,-0.0101704233095107
"1777","cha",34761,31,11,35.5,99,33,12,36.4,0,-2,-1,-0.899999999999999,0.333333333333333,0.342857142857143,-0.00952380952380955
"1778","cha",34777,38,13,34.2,85,32,12,37.5,0,6,1,-3.3,0.458823529411765,0.4,0.0588235294117647
"1779","cha",34791,30,7,23.3,108,37,15,40.5,0,-7,-8,-17.2,0.194444444444444,0.394736842105263,-0.200292397660819
"1780","cha",34806,38,14,36.8,99,28,11,39.3,1,10,3,-2.5,0.424242424242424,0.388235294117647,0.0360071301247772
"1781","cha",34821,40,18,45,121,32,10,31.2,0,8,8,13.8,0.446280991735537,0.241935483870968,0.204345507864569
"1782","cha",34834,39,16,41,109,32,12,37.5,1,7,4,3.5,0.440366972477064,0.346153846153846,0.0942131263232181
"1783","cha",34847,34,10,29.4,103,19,7,36.8,0,15,3,-7.4,0.29126213592233,0.175,0.11626213592233
"1784","cha",34863,27,16,59.3,112,30,9,30,1,-3,7,29.3,0.428571428571429,0.264705882352941,0.163865546218487
"1785","cha",34881,31,11,35.5,100,30,12,40,1,1,-1,-4.5,0.33,0.409090909090909,-0.0790909090909091
"1786","cha",34891,21,7,33.3,101,41,17,41.5,0,-20,-10,-8.2,0.207920792079208,0.472222222222222,-0.264301430143014
"1787","cha",34905,21,10,47.6,121,27,5,18.5,1,-6,5,29.1,0.247933884297521,0.185185185185185,0.0627486991123355
"1788","cha",34916,46,13,28.3,122,34,14,41.2,0,12,-1,-12.9,0.319672131147541,0.336,-0.016327868852459
"1789","cha",34931,29,7,24.1,109,40,14,35,0,-11,-7,-10.9,0.192660550458716,0.365217391304348,-0.172556840845632
"1790","cha",34945,23,3,13,77,28,12,42.9,0,-5,-9,-29.9,0.116883116883117,0.36734693877551,-0.250463821892393
"1791","cha",34970,24,9,37.5,98,33,11,33.3,1,-9,-2,4.2,0.275510204081633,0.354838709677419,-0.0793285055957867
"1792","cha",34984,30,12,40,105,37,12,32.4,1,-7,0,7.6,0.342857142857143,0.4,-0.0571428571428572
"1793","cha",34999,27,9,33.3,109,40,14,35,1,-13,-5,-1.7,0.247706422018349,0.411764705882353,-0.164058283864004
"1794","cha",35013,38,10,26.3,105,25,9,36,0,13,1,-9.7,0.285714285714286,0.241071428571429,0.0446428571428571
"1795","cha",35027,30,14,46.7,120,16,6,37.5,1,14,8,9.2,0.35,0.169811320754717,0.180188679245283
"1796","cha",35043,28,7,25,108,30,14,46.7,0,-2,-7,-21.7,0.194444444444444,0.355932203389831,-0.161487758945386
"1797","cha",35054,32,16,50,110,31,11,35.5,1,1,5,14.5,0.436363636363636,0.311320754716981,0.125042881646655
"1798","cha",35067,36,17,47.2,122,33,16,48.5,1,3,1,-1.3,0.418032786885246,0.421052631578947,-0.00301984469370142
"1799","cha",35083,30,11,36.7,113,31,12,38.7,1,-1,-1,-2,0.292035398230089,0.356435643564356,-0.0644002453342679
"1800","cha",35095,34,12,35.3,111,34,17,50,0,0,-5,-14.7,0.324324324324324,0.432203389830508,-0.107879065506184
"1801","cha",35105,25,8,32,99,40,21,52.5,0,-15,-13,-20.5,0.242424242424242,0.5625,-0.320075757575758
"1802","cha",35129,28,9,32.1,114,39,17,43.6,0,-11,-8,-11.5,0.236842105263158,0.421487603305785,-0.184645498042627
"1803","cha",35147,18,5,27.8,79,28,16,57.1,0,-10,-11,-29.3,0.189873417721519,0.539325842696629,-0.34945242497511
"1804","cha",35152,23,3,13,76,27,7,25.9,0,-4,-4,-12.9,0.118421052631579,0.203883495145631,-0.0854624425140521
"1805","mia",33944,16,4,25,108,18,6,33.3,1,-2,-2,-8.3,0.111111111111111,0.1875,-0.0763888888888889
"1806","mia",33962,34,14,41.2,91,22,7,31.8,0,12,7,9.4,0.461538461538462,0.216494845360825,0.245043616177637
"1807","mia",33977,20,7,35,99,18,10,55.6,0,2,-3,-20.6,0.212121212121212,0.283018867924528,-0.0708976558033162
"1808","mia",33989,29,13,44.8,108,23,5,21.7,1,6,8,23.1,0.361111111111111,0.15625,0.204861111111111
"1809","mia",34011,28,9,32.1,87,25,6,24,0,3,3,8.1,0.310344827586207,0.1875,0.122844827586207
"1810","mia",34037,17,4,23.5,85,28,9,32.1,0,-11,-5,-8.6,0.141176470588235,0.278350515463918,-0.137174044875682
"1811","mia",34058,29,13,44.8,95,16,6,37.5,0,13,7,7.3,0.410526315789474,0.183673469387755,0.226852846401719
"1812","mia",34076,17,5,29.4,91,20,6,30,0,-3,-1,-0.600000000000001,0.164835164835165,0.176470588235294,-0.0116354234001293
"1813","mia",34090,15,4,26.7,90,15,8,53.3,0,0,-4,-26.6,0.133333333333333,0.25531914893617,-0.121985815602837
"1814","mia",34094,23,7,30.4,90,17,6,35.3,0,6,1,-4.9,0.233333333333333,0.193548387096774,0.0397849462365591
"1815","mia",34110,30,7,23.3,96,23,7,30.4,1,7,0,-7.1,0.21875,0.287671232876712,-0.0689212328767123
"1816","mia",34126,27,13,48.2,114,27,11,40.7,1,0,2,7.5,0.342105263157895,0.297297297297297,0.0448079658605974
"1817","mia",34139,31,7,22.6,94,26,11,42.3,0,5,-4,-19.7,0.223404255319149,0.326732673267327,-0.103328417948178
"1818","mia",34158,26,7,26.9,84,19,6,31.6,0,7,1,-4.7,0.25,0.168224299065421,0.0817757009345794
"1819","mia",34173,31,12,38.7,90,19,4,21,1,12,8,17.7,0.4,0.148148148148148,0.251851851851852
"1820","mia",34183,31,11,35.5,107,25,9,36,0,6,2,-0.5,0.308411214953271,0.245454545454545,0.0629566694987256
"1821","mia",34196,30,6,20,104,27,11,40.7,0,3,-5,-20.7,0.173076923076923,0.294642857142857,-0.121565934065934
"1822","mia",34213,24,9,37.5,106,22,7,31.8,1,2,2,5.7,0.254716981132075,0.214285714285714,0.0404312668463612
"1823","mia",34220,19,8,42.1,111,30,17,56.7,1,-11,-9,-14.6,0.216216216216216,0.463636363636364,-0.247420147420147
"1824","mia",34238,22,6,27.3,92,24,9,37.5,0,-2,-3,-10.2,0.195652173913043,0.272727272727273,-0.0770750988142292
"1825","mia",34256,25,11,44,103,25,7,28,0,0,4,16,0.320388349514563,0.184210526315789,0.136177823198774
"1826","mia",34264,27,11,40.7,95,19,4,21,0,8,7,19.7,0.347368421052632,0.116504854368932,0.2308635666837
"1827","mia",34278,27,6,22.2,84,24,9,37.5,0,3,-3,-15.3,0.214285714285714,0.236842105263158,-0.0225563909774436
"1828","mia",34290,20,5,25,100,8,1,12.5,0,12,4,12.5,0.15,0.0285714285714286,0.121428571428571
"1829","mia",34303,26,9,34.6,112,23,5,21.7,1,3,4,12.9,0.241071428571429,0.148514851485149,0.0925565770862801
"1830","mia",34317,25,7,28,95,27,9,33.3,1,-2,-2,-5.3,0.221052631578947,0.303370786516854,-0.0823181549379066
"1831","mia",34337,27,6,22.2,98,25,7,28,0,2,-1,-5.8,0.183673469387755,0.205882352941176,-0.0222088835534213
"1832","mia",34350,24,9,37.5,95,28,9,32.1,0,-4,0,5.4,0.284210526315789,0.257142857142857,0.0270676691729324
"1833","mia",34362,30,12,40,130,22,11,50,0,8,1,-10,0.276923076923077,0.242647058823529,0.0342760180995475
"1834","mia",34379,22,11,50,115,38,14,36.8,1,-16,-3,13.2,0.28695652173913,0.392523364485981,-0.105566842746851
"1835","mia",34389,20,8,40,87,28,11,39.3,0,-8,-3,0.700000000000003,0.275862068965517,0.362637362637363,-0.0867752936718454
"1836","mia",34413,23,7,30.4,94,19,5,26.3,0,4,2,4.1,0.223404255319149,0.141509433962264,0.0818948213568848
"1837","mia",34426,28,10,35.7,82,26,5,19.2,0,2,5,16.5,0.365853658536585,0.164835164835165,0.201018493701421
"1838","mia",34434,28,11,39.3,114,32,17,53.1,0,-4,-6,-13.8,0.289473684210526,0.435897435897436,-0.14642375168691
"1839","mia",34449,26,14,53.8,98,22,9,40.9,0,4,5,12.9,0.428571428571429,0.252336448598131,0.176234979973298
"1840","mia",34467,23,6,26.1,90,23,9,39.1,0,0,-3,-13,0.2,0.272727272727273,-0.0727272727272727
"1841","mia",34475,28,12,42.9,107,20,8,40,1,8,4,2.9,0.336448598130841,0.235294117647059,0.101154480483782
"1842","mia",34489,32,8,25,100,28,10,35.7,0,4,-2,-10.7,0.24,0.236220472440945,0.00377952755905511
"1843","mia",34501,27,7,25.9,86,30,9,30,0,-3,-2,-4.1,0.244186046511628,0.275510204081633,-0.0313241575700047
"1844","mia",34518,30,6,20,95,27,11,40.7,0,3,-5,-20.7,0.189473684210526,0.308411214953271,-0.118937530742745
"1845","mia",34534,32,12,37.5,108,15,9,60,0,17,3,-22.5,0.333333333333333,0.232758620689655,0.100574712643678
"1846","mia",34563,29,9,31,109,39,9,23.1,1,-10,0,7.9,0.247706422018349,0.262135922330097,-0.0144295003117484
"1847","mia",34577,20,9,45,99,36,14,38.9,1,-16,-5,6.1,0.272727272727273,0.442105263157895,-0.169377990430622
"1848","mia",34595,30,13,43.3,109,18,6,33.3,1,12,7,10,0.357798165137615,0.185567010309278,0.172231154828336
"1849","mia",34608,30,13,43.3,105,30,8,26.7,1,0,5,16.6,0.371428571428571,0.235294117647059,0.136134453781513
"1850","mia",34622,23,11,47.8,109,35,13,37.1,1,-12,-2,10.7,0.302752293577982,0.367924528301887,-0.0651722347239051
"1851","mia",34640,24,9,37.5,100,13,3,23.1,1,11,6,14.4,0.27,0.102272727272727,0.167727272727273
"1852","mia",34645,28,14,50,116,12,4,33.3,1,16,10,16.7,0.362068965517241,0.116504854368932,0.245564111148309
"1853","mia",34659,26,11,42.3,104,26,4,15.4,1,0,7,26.9,0.317307692307692,0.125,0.192307692307692
"1854","mia",34674,32,12,37.5,116,26,7,26.9,1,6,5,10.6,0.310344827586207,0.225806451612903,0.0845383759733037
"1855","mia",34698,22,12,54.6,125,23,6,26.1,1,-1,6,28.5,0.288,0.176470588235294,0.111529411764706
"1856","mia",34715,28,15,53.6,115,11,5,45.4,1,17,10,8.2,0.391304347826087,0.132743362831858,0.258560984994229
"1857","mia",34727,33,11,33.3,106,15,6,40,1,18,5,-6.7,0.311320754716981,0.204545454545455,0.106775300171527
"1858","mia",34739,23,7,30.4,108,20,8,40,1,3,-1,-9.6,0.194444444444444,0.242424242424242,-0.047979797979798
"1859","mia",34750,23,7,30.4,109,25,9,36,0,-2,-2,-5.6,0.192660550458716,0.230769230769231,-0.0381086803105152
"1860","mia",34763,22,6,27.3,107,14,8,57.1,0,8,-2,-29.8,0.168224299065421,0.206896551724138,-0.0386722526587174
"1861","mia",34781,35,13,37.1,117,40,13,32.5,1,-5,0,4.6,0.333333333333333,0.357798165137615,-0.0244648318042814
"1862","mia",34803,37,17,46,108,20,6,30,1,17,11,16,0.472222222222222,0.2,0.272222222222222
"1863","mia",34809,31,13,41.9,113,12,4,33.3,1,19,9,8.6,0.345132743362832,0.126315789473684,0.218816953889148
"1864","mia",34827,26,9,34.6,89,18,9,50,0,8,0,-15.4,0.303370786516854,0.28125,0.022120786516854
"1865","mia",34838,30,13,43.3,125,17,6,35.3,1,13,7,8,0.312,0.183673469387755,0.128326530612245
"1866","mia",34851,28,8,28.6,99,17,5,29.4,0,11,3,-0.799999999999997,0.242424242424242,0.136363636363636,0.106060606060606
"1867","mia",34861,34,18,52.9,120,27,11,40.7,1,7,7,12.2,0.45,0.358695652173913,0.091304347826087
"1868","mia",34876,35,16,45.7,106,27,9,33.3,1,8,7,12.4,0.452830188679245,0.275510204081633,0.177319984597613
"1869","mia",34891,41,17,41.5,108,21,7,33.3,1,20,10,8.2,0.472222222222222,0.207920792079208,0.264301430143014
"1870","mia",34919,28,11,39.3,104,15,2,13.3,1,13,9,26,0.317307692307692,0.0674157303370786,0.249891961970614
"1871","mia",34927,32,9,28.1,98,15,5,33.3,0,17,4,-5.2,0.275510204081633,0.147058823529412,0.128451380552221
"1872","mia",34947,35,16,45.7,120,22,9,40.9,1,13,7,4.8,0.4,0.241071428571429,0.158928571428571
"1873","mia",34965,26,8,30.8,123,12,2,16.7,1,14,6,14.1,0.195121951219512,0.0571428571428571,0.137979094076655
"1874","mia",34981,31,9,29,104,26,13,50,0,5,-4,-21,0.259615384615385,0.339130434782609,-0.079515050167224
"1875","mia",34993,27,11,40.7,112,16,4,25,1,11,7,15.7,0.294642857142857,0.123711340206186,0.170931516936672
"1876","mia",35008,23,6,26.1,84,23,6,26.1,0,0,0,0,0.214285714285714,0.178217821782178,0.0360678925035361
"1877","mia",35033,29,7,24.1,108,24,8,33.3,0,5,-1,-9.2,0.194444444444444,0.214285714285714,-0.0198412698412698
"1878","mia",35047,21,5,23.8,97,27,8,29.6,1,-6,-3,-5.8,0.154639175257732,0.25,-0.095360824742268
"1879","mia",35055,25,12,48,105,25,5,20,1,0,7,28,0.342857142857143,0.170454545454545,0.172402597402597
"1880","mia",35073,33,8,24.2,94,16,6,37.5,0,17,2,-13.3,0.25531914893617,0.183673469387755,0.0716456795484151
"1881","mia",35090,26,13,50,113,20,5,25,0,6,8,25,0.345132743362832,0.129310344827586,0.215822398535246
"1882","mia",35105,40,21,52.5,112,25,8,32,1,15,13,20.5,0.5625,0.242424242424242,0.320075757575758
"1883","mia",35120,23,8,34.8,94,20,9,45,0,3,-1,-10.2,0.25531914893617,0.28125,-0.0259308510638298
"1884","mia",35132,18,7,38.9,106,22,8,36.4,1,-4,-1,2.5,0.19811320754717,0.233009708737864,-0.0348965011906943
"1885","mia",35145,33,12,36.4,124,35,14,40,1,-2,-2,-3.6,0.290322580645161,0.347107438016529,-0.0567848573713676
"1886","mia",35161,24,8,33.3,110,26,7,26.9,1,-2,1,6.4,0.218181818181818,0.205882352941176,0.0122994652406417
"1887","orl",33944,18,6,33.3,96,16,4,25,0,2,2,8.3,0.1875,0.111111111111111,0.0763888888888889
"1888","orl",33960,26,8,30.8,82,19,7,36.8,0,7,1,-6,0.292682926829268,0.194444444444444,0.0982384823848238
"1889","orl",33969,28,8,28.6,99,37,11,29.7,0,-9,-3,-1.1,0.242424242424242,0.314285714285714,-0.0718614718614718
"1890","orl",33986,25,6,24,103,20,9,45,1,5,-3,-21,0.174757281553398,0.267326732673267,-0.0925694511198693
"1891","orl",34005,30,10,33.3,102,18,7,38.9,1,12,3,-5.6,0.294117647058824,0.223404255319149,0.0707133917396746
"1892","orl",34021,28,9,32.1,88,17,6,35.3,1,11,3,-3.2,0.306818181818182,0.209302325581395,0.0975158562367865
"1893","orl",34036,30,9,30,80,19,3,15.8,0,11,6,14.2,0.3375,0.0803571428571429,0.257142857142857
"1894","orl",34049,24,8,33.3,107,23,13,56.5,0,1,-5,-23.2,0.224299065420561,0.317073170731707,-0.0927741053111466
"1895","orl",34064,20,8,40,74,28,7,25,0,-8,1,15,0.324324324324324,0.241379310344828,0.0829450139794967
"1896","orl",34081,24,11,45.8,119,25,7,28,1,-1,4,17.8,0.277310924369748,0.179487179487179,0.0978237448825684
"1897","orl",34085,25,5,20,69,25,8,32,0,0,-3,-12,0.217391304347826,0.272727272727273,-0.0553359683794466
"1898","orl",34099,27,10,37,89,21,7,33.3,1,6,3,3.7,0.337078651685393,0.25609756097561,0.0809810907097835
"1899","orl",34127,21,8,38.1,95,28,13,46.4,1,-7,-5,-8.3,0.252631578947368,0.448275862068966,-0.195644283121597
"1900","orl",34144,25,7,28,89,29,8,27.6,0,-4,-1,0.399999999999999,0.235955056179775,0.258064516129032,-0.022109459949257
"1901","orl",34154,25,7,28,87,22,9,40.9,0,3,-2,-12.9,0.241379310344828,0.293478260869565,-0.0520989505247376
"1902","orl",34166,23,7,30.4,91,29,6,20.7,0,-6,1,9.7,0.230769230769231,0.191489361702128,0.0392798690671031
"1903","orl",34188,28,7,25,96,24,8,33.3,0,4,-1,-8.3,0.21875,0.230769230769231,-0.0120192307692308
"1904","orl",34204,15,6,40,95,20,5,25,1,-5,1,15,0.189473684210526,0.180722891566265,0.00875079264426126
"1905","orl",34218,24,6,25,94,18,7,38.9,0,6,-1,-13.9,0.191489361702128,0.221052631578947,-0.0295632698768197
"1906","orl",34222,26,13,50,105,32,9,28.1,1,-6,4,21.9,0.371428571428571,0.306818181818182,0.0646103896103896
"1907","orl",34240,23,7,30.4,98,27,10,37,1,-4,-3,-6.6,0.214285714285714,0.326086956521739,-0.111801242236025
"1908","orl",34255,26,12,46.2,124,23,11,47.8,1,3,1,-1.59999999999999,0.290322580645161,0.28448275862069,0.00583982202447164
"1909","orl",34262,26,11,42.3,87,26,7,26.9,0,0,4,15.4,0.379310344827586,0.179487179487179,0.199823165340407
"1910","orl",34277,34,9,26.5,88,22,9,40.9,0,12,0,-14.4,0.306818181818182,0.247706422018349,0.0591117597998332
"1911","orl",34287,27,11,40.7,113,19,8,42.1,0,8,3,-1.4,0.292035398230089,0.198347107438017,0.093688290792072
"1912","orl",34309,34,15,44.1,131,28,11,39.3,1,6,4,4.8,0.343511450381679,0.275,0.0685114503816794
"1913","orl",34316,33,14,42.4,108,25,13,52,0,8,1,-9.6,0.388888888888889,0.345132743362832,0.0437561455260571
"1914","orl",34330,29,7,24.1,118,27,11,40.7,1,2,-4,-16.6,0.177966101694915,0.297297297297297,-0.119331195602382
"1915","orl",34349,21,3,14.3,79,27,7,25.9,0,-6,-4,-11.6,0.113924050632911,0.192660550458716,-0.0787364998258042
"1916","orl",34362,22,11,50,136,30,12,40,1,-8,-1,10,0.242647058823529,0.276923076923077,-0.0342760180995475
"1917","orl",34378,27,5,18.5,95,20,9,45,0,7,-4,-26.5,0.157894736842105,0.254716981132075,-0.0968222442899702
"1918","orl",34383,27,11,40.7,109,23,8,34.8,1,4,3,5.90000000000001,0.302752293577982,0.266666666666667,0.036085626911315
"1919","orl",34402,26,13,50,112,25,10,40,1,1,3,10,0.348214285714286,0.294117647058824,0.0540966386554622
"1920","orl",34417,34,9,26.5,101,24,10,41.7,0,10,-1,-15.2,0.267326732673267,0.25,0.0173267326732673
"1921","orl",34450,38,10,26.3,104,22,9,40.9,0,16,1,-14.6,0.288461538461538,0.230769230769231,0.0576923076923077
"1922","orl",34456,31,15,48.4,115,21,8,38.1,1,10,7,10.3,0.391304347826087,0.233009708737864,0.158294639088223
"1923","orl",34470,28,9,32.1,92,19,10,52.6,0,9,-1,-20.5,0.293478260869565,0.27027027027027,0.023207990599295
"1924","orl",34485,23,8,34.8,93,49,15,30.6,0,-26,-7,4.2,0.258064516129032,0.45,-0.191935483870968
"1925","orl",34507,26,7,26.9,95,32,8,25,0,-6,-1,1.9,0.221052631578947,0.216216216216216,0.00483641536273113
"1926","orl",34524,27,6,22.2,96,26,9,34.6,0,1,-3,-12.4,0.1875,0.257142857142857,-0.0696428571428571
"1927","orl",34538,18,10,55.6,115,34,10,29.4,1,-16,0,26.2,0.260869565217391,0.275229357798165,-0.0143597925807739
"1928","orl",34545,34,12,35.3,107,26,7,26.9,0,8,5,8.4,0.336448598130841,0.184210526315789,0.152238071815052
"1929","orl",34557,25,8,32,112,27,9,33.3,0,-2,-1,-1.3,0.214285714285714,0.216,-0.00171428571428572
"1930","orl",34571,32,11,34.4,98,36,15,41.7,0,-4,-4,-7.3,0.336734693877551,0.38135593220339,-0.0446212383258388
"1931","orl",34583,28,8,28.6,112,25,10,40,1,3,-2,-11.4,0.214285714285714,0.3125,-0.0982142857142857
"1932","orl",34601,28,7,25,98,42,19,45.2,0,-14,-12,-20.2,0.214285714285714,0.483050847457627,-0.268765133171913
"1933","orl",34617,22,7,31.8,92,22,7,31.8,0,0,0,0,0.228260869565217,0.21,0.0182608695652174
"1934","orl",34637,25,9,36,98,34,16,47.1,0,-9,-7,-11.1,0.275510204081633,0.375,-0.0994897959183674
"1935","orl",34655,23,10,43.5,114,28,12,42.9,1,-5,-2,0.600000000000001,0.263157894736842,0.31858407079646,-0.0554261760596181
"1936","orl",34660,35,10,28.6,105,29,12,41.4,0,6,-2,-12.8,0.285714285714286,0.324324324324324,-0.0386100386100386
"1937","orl",34670,24,6,25,88,20,9,45,0,4,-3,-20,0.204545454545455,0.275510204081633,-0.0709647495361781
"1938","orl",34686,14,5,35.7,102,28,10,35.7,1,-14,-5,0,0.147058823529412,0.319148936170213,-0.172090112640801
"1939","orl",34696,27,7,25.9,86,28,10,35.7,0,-1,-3,-9.8,0.244186046511628,0.265486725663717,-0.0213006791520889
"1940","orl",34720,25,6,24,104,38,16,42.1,0,-13,-10,-18.1,0.173076923076923,0.375,-0.201923076923077
"1941","orl",34735,21,10,47.6,111,28,11,39.3,0,-7,-1,8.3,0.27027027027027,0.294642857142857,-0.0243725868725869
"1942","orl",34754,23,3,13,80,35,17,48.6,0,-12,-14,-35.6,0.1125,0.455357142857143,-0.342857142857143
"1943","orl",34763,14,8,57.1,116,22,6,27.3,1,-8,2,29.8,0.206896551724138,0.168224299065421,0.0386722526587174
"1944","orl",34774,18,4,22.2,79,31,8,25.8,0,-13,-4,-3.6,0.151898734177215,0.224299065420561,-0.0724003312433456
"1945","orl",34790,22,7,31.8,103,19,9,47.4,0,3,-2,-15.6,0.203883495145631,0.241071428571429,-0.0371879334257975
"1946","orl",34807,27,8,29.6,105,25,8,32,1,2,0,-2.4,0.228571428571429,0.27906976744186,-0.0504983388704319
"1947","orl",34835,25,5,20,90,29,8,27.6,0,-4,-3,-7.6,0.166666666666667,0.237623762376238,-0.070957095709571
"1948","orl",34851,17,5,29.4,110,28,8,28.6,1,-11,-3,0.799999999999997,0.136363636363636,0.242424242424242,-0.106060606060606
"1949","orl",34870,35,14,40,114,26,14,53.8,0,9,0,-13.8,0.368421052631579,0.365217391304348,0.0032036613272311
"1950","orl",34875,32,9,28.1,105,14,6,42.9,0,18,3,-14.8,0.257142857142857,0.15929203539823,0.097850821744627
"1951","orl",34889,25,7,28,98,28,12,42.9,1,-3,-5,-14.9,0.214285714285714,0.395604395604396,-0.181318681318681
"1952","orl",34905,27,5,18.5,81,21,10,47.6,0,6,-5,-29.1,0.185185185185185,0.247933884297521,-0.0627486991123355
"1953","orl",34917,21,4,19,104,39,15,38.5,0,-18,-11,-19.5,0.115384615384615,0.387931034482759,-0.272546419098143
"1954","orl",34937,34,13,38.2,115,30,16,53.3,0,4,-3,-15.1,0.339130434782609,0.4,-0.0608695652173913
"1955","orl",34959,27,7,25.9,92,26,10,38.5,0,1,-3,-12.6,0.228260869565217,0.245901639344262,-0.0176407697790449
"1956","orl",34966,23,7,30.4,109,14,2,14.3,1,9,5,16.1,0.192660550458716,0.058252427184466,0.13440812327425
"1957","orl",34985,23,4,17.4,112,34,9,26.5,1,-11,-5,-9.1,0.107142857142857,0.247706422018349,-0.140563564875491
"1958","orl",34999,40,14,35,102,27,9,33.3,0,13,5,1.7,0.411764705882353,0.247706422018349,0.164058283864004
"1959","orl",35014,26,12,46.2,115,22,2,9.1,1,4,10,37.1,0.31304347826087,0.0689655172413793,0.24407796101949
"1960","orl",35037,20,4,20,112,15,10,66.7,0,5,-6,-46.7,0.107142857142857,0.229007633587786,-0.121864776444929
"1961","orl",35052,30,9,30,106,33,10,30.3,0,-3,-1,-0.300000000000001,0.254716981132075,0.263157894736842,-0.00844091360476662
"1962","orl",35069,30,12,40,116,33,12,36.4,0,-3,0,3.6,0.310344827586207,0.307692307692308,0.0026525198938992
"1963","orl",35079,25,10,40,111,31,8,25.8,0,-6,2,14.2,0.27027027027027,0.198347107438017,0.0719231628322538
"1964","orl",35096,33,11,33.3,102,36,18,50,0,-3,-7,-16.7,0.323529411764706,0.442622950819672,-0.119093539054966
"1965","orl",35114,25,9,36,115,30,11,36.7,1,-5,-2,-0.700000000000003,0.234782608695652,0.308411214953271,-0.0736286062576188
"1966","orl",35130,30,14,46.7,112,22,11,50,0,8,3,-3.3,0.375,0.259842519685039,0.115157480314961
"1967","orl",35146,27,5,18.5,75,26,12,46.2,0,1,-7,-27.7,0.2,0.295081967213115,-0.0950819672131147
"1968","orl",35157,25,13,52,113,35,11,31.4,1,-10,2,20.6,0.345132743362832,0.302752293577982,0.0423804497848502
"1969","was",33954,20,6,30,99,26,12,46.2,0,-6,-6,-16.2,0.181818181818182,0.315789473684211,-0.133971291866029
"1970","was",33979,25,5,20,103,31,15,48.4,0,-6,-10,-28.4,0.145631067961165,0.401785714285714,-0.256154646324549
"1971","was",33995,10,3,30,103,25,10,40,0,-15,-7,-10,0.087378640776699,0.265486725663717,-0.178108084887018
"1972","was",34010,20,5,25,95,25,5,20,1,-5,0,5,0.157894736842105,0.16304347826087,-0.00514874141876431
"1973","was",34021,17,6,35.3,86,28,9,32.1,0,-11,-3,3.2,0.209302325581395,0.306818181818182,-0.0975158562367865
"1974","was",34034,27,10,37,106,37,17,46,0,-10,-7,-9,0.283018867924528,0.447368421052632,-0.164349553128103
"1975","was",34047,21,10,47.6,118,31,10,32.3,1,-10,0,15.3,0.254237288135593,0.32258064516129,-0.0683433570256971
"1976","was",34062,15,3,20,94,33,14,42.4,0,-18,-11,-22.4,0.0957446808510638,0.4,-0.304255319148936
"1977","was",34073,13,4,30.8,95,15,5,33.3,0,-2,-1,-2.5,0.126315789473684,0.141509433962264,-0.0151936444885799
"1978","was",34098,23,8,34.8,102,28,10,35.7,0,-5,-2,-0.900000000000006,0.235294117647059,0.275229357798165,-0.0399352401511063
"1979","was",34109,25,15,60,119,29,12,41.4,1,-4,3,18.6,0.378151260504202,0.321428571428571,0.0567226890756302
"1980","was",34126,27,11,40.7,111,27,13,48.2,0,0,-2,-7.5,0.297297297297297,0.342105263157895,-0.0448079658605974
"1981","was",34140,28,10,35.7,106,27,11,40.7,1,1,-1,-5,0.283018867924528,0.326732673267327,-0.0437138053427985
"1982","was",34166,29,6,20.7,94,23,7,30.4,1,6,-1,-9.7,0.191489361702128,0.230769230769231,-0.0392798690671031
"1983","was",34180,22,6,27.3,100,24,9,37.5,0,-2,-3,-10.2,0.18,0.241071428571429,-0.0610714285714286
"1984","was",34193,25,10,40,101,21,3,14.3,1,4,7,25.7,0.297029702970297,0.0947368421052632,0.202292860865034
"1985","was",34210,28,10,35.7,115,30,12,40,0,-2,-2,-4.3,0.260869565217391,0.285714285714286,-0.0248447204968944
"1986","was",34229,11,7,63.6,105,20,8,40,0,-9,-1,23.6,0.2,0.224299065420561,-0.0242990654205607
"1987","was",34246,34,14,41.2,118,27,11,40.7,1,7,3,0.5,0.355932203389831,0.292035398230089,0.063896805159742
"1988","was",34255,23,11,47.8,116,26,12,46.2,0,-3,-1,1.59999999999999,0.28448275862069,0.290322580645161,-0.00583982202447164
"1989","was",34272,19,6,31.6,92,32,7,21.9,1,-13,-1,9.7,0.195652173913043,0.247058823529412,-0.0514066496163683
"1990","was",34286,21,8,38.1,110,25,13,52,1,-4,-5,-13.9,0.218181818181818,0.371428571428571,-0.153246753246753
"1991","was",34303,23,5,21.7,101,26,9,34.6,0,-3,-4,-12.9,0.148514851485149,0.241071428571429,-0.0925565770862801
"1992","was",34315,18,5,27.8,109,33,14,42.4,1,-15,-9,-14.6,0.137614678899083,0.39622641509434,-0.258611736195257
"1993","was",34329,25,12,48,122,28,10,35.7,1,-3,2,12.3,0.295081967213115,0.277777777777778,0.017304189435337
"1994","was",34346,19,10,52.6,117,24,7,29.2,1,-5,3,23.4,0.256410256410256,0.190909090909091,0.0655011655011655
"1995","was",34353,33,8,24.2,105,21,7,33.3,0,12,1,-9.1,0.228571428571429,0.196261682242991,0.0323097463284379
"1996","was",34372,18,3,16.7,107,21,6,28.6,1,-3,-3,-11.9,0.0841121495327103,0.185567010309278,-0.101454860776568
"1997","was",34387,24,7,29.2,96,25,9,36,0,-1,-2,-6.8,0.21875,0.219512195121951,-0.00076219512195122
"1998","was",34401,29,12,41.4,107,21,6,28.6,1,8,6,12.8,0.336448598130841,0.176470588235294,0.159978009895547
"1999","was",34416,22,8,36.4,111,28,11,39.3,1,-6,-3,-2.9,0.216216216216216,0.314285714285714,-0.0980694980694981
"2000","was",34433,22,11,50,118,25,10,40,1,-3,1,10,0.279661016949153,0.315789473684211,-0.036128456735058
"2001","was",34458,26,6,23.1,91,39,12,30.8,0,-13,-6,-7.7,0.197802197802198,0.356435643564356,-0.158633445762159
"2002","was",34464,30,11,36.7,105,32,17,53.1,0,-2,-6,-16.4,0.314285714285714,0.451327433628319,-0.137041719342604
"2003","was",34484,22,12,54.6,112,18,7,38.9,1,4,5,15.7,0.321428571428571,0.2,0.121428571428571
"2004","was",34502,32,10,31.2,107,23,9,39.1,1,9,1,-7.9,0.280373831775701,0.267326732673267,0.0130470991024336
"2005","was",34511,22,11,50,101,27,10,37,1,-5,1,13,0.326732673267327,0.303030303030303,0.0237023702370237
"2006","was",34523,26,10,38.5,108,41,17,41.5,0,-15,-7,-3,0.277777777777778,0.435897435897436,-0.158119658119658
"2007","was",34544,17,8,47.1,109,31,10,32.3,1,-14,-2,14.8,0.220183486238532,0.32258064516129,-0.102397158922758
"2008","was",34554,23,13,56.5,120,26,8,30.8,1,-3,5,25.7,0.325,0.237623762376238,0.0873762376237624
"2009","was",34568,29,8,27.6,104,25,8,32,1,4,0,-4.4,0.230769230769231,0.237623762376238,-0.00685453160700683
"2010","was",34578,32,13,40.6,113,24,7,29.2,1,8,6,11.4,0.345132743362832,0.190909090909091,0.154223652453741
"2011","was",34591,26,8,30.8,112,28,11,39.3,0,-2,-3,-8.5,0.214285714285714,0.292035398230089,-0.0777496839443742
"2012","was",34605,25,10,40,109,32,8,25,1,-7,2,15,0.275229357798165,0.242424242424242,0.0328051153739227
"2013","was",34616,20,9,45,123,33,10,30.3,1,-13,-1,14.7,0.219512195121951,0.277777777777778,-0.0582655826558266
"2014","was",34642,31,13,41.9,112,31,9,29,1,0,4,12.9,0.348214285714286,0.313953488372093,0.0342607973421927
"2015","was",34654,21,10,47.6,107,32,10,31.2,1,-11,0,16.4,0.280373831775701,0.319148936170213,-0.0387751043945119
"2016","was",34664,22,7,31.8,117,24,5,20.8,1,-2,2,11,0.179487179487179,0.148514851485149,0.030972328002031
"2017","was",34682,33,12,36.4,116,39,12,30.8,1,-6,0,5.6,0.310344827586207,0.333333333333333,-0.0229885057471264
"2018","was",34695,31,10,32.3,105,17,5,29.4,1,14,5,2.9,0.285714285714286,0.164835164835165,0.120879120879121
"2019","was",34709,29,12,41.4,135,38,19,50,0,-9,-7,-8.6,0.266666666666667,0.407142857142857,-0.14047619047619
"2020","was",34724,25,9,36,114,33,9,27.3,1,-8,0,8.7,0.236842105263158,0.245454545454545,-0.00861244019138757
"2021","was",34745,29,10,34.5,112,21,4,19,1,8,6,15.5,0.267857142857143,0.11214953271028,0.155707610146862
"2022","was",34760,21,13,61.9,120,34,7,20.6,1,-13,6,41.3,0.325,0.214285714285714,0.110714285714286
"2023","was",34788,29,15,51.7,111,18,4,22.2,1,11,11,29.5,0.405405405405405,0.122448979591837,0.282956425813569
"2024","was",34796,24,5,20.8,112,29,10,34.5,0,-5,-5,-13.7,0.133928571428571,0.25,-0.116071428571429
"2025","was",34817,22,8,36.4,92,24,11,45.8,0,-2,-3,-9.4,0.260869565217391,0.323529411764706,-0.0626598465473146
"2026","was",34829,28,12,42.9,112,28,8,28.6,1,0,4,14.3,0.321428571428571,0.222222222222222,0.0992063492063492
"2027","was",34836,25,9,36,105,20,7,35,1,5,2,1,0.257142857142857,0.21875,0.0383928571428571
"2028","was",34850,30,10,33.3,106,25,11,44,0,5,-1,-10.7,0.283018867924528,0.289473684210526,-0.00645481628599803
"2029","was",34870,26,14,53.8,115,35,14,40,1,-9,0,13.8,0.365217391304348,0.368421052631579,-0.0032036613272311
"2030","was",34888,18,7,38.9,131,27,13,48.2,1,-9,-6,-9.3,0.16030534351145,0.307086614173228,-0.146781270661778
"2031","was",34898,26,11,42.3,123,28,13,46.4,1,-2,-2,-4.1,0.268292682926829,0.345132743362832,-0.0768400604360026
"2032","was",34912,26,9,34.6,130,22,12,54.6,1,4,-3,-20,0.207692307692308,0.295081967213115,-0.087389659520807
"2033","was",34923,25,12,48,125,32,16,50,1,-7,-4,-2,0.288,0.387096774193548,-0.0990967741935484
"2034","was",34935,26,7,26.9,104,21,10,47.6,0,5,-3,-20.7,0.201923076923077,0.252100840336134,-0.0501777634130575
"2035","was",34944,30,12,40,107,32,14,43.8,0,-2,-2,-3.8,0.336448598130841,0.375,-0.0385514018691589
"2036","was",34961,26,10,38.5,112,27,7,25.9,1,-1,3,12.6,0.267857142857143,0.196261682242991,0.0715954606141522
"2037","was",34970,33,11,33.3,93,24,9,37.5,0,9,2,-4.2,0.354838709677419,0.275510204081633,0.0793285055957867
"2038","was",34987,35,8,22.9,102,33,10,30.3,0,2,-2,-7.4,0.235294117647059,0.272727272727273,-0.0374331550802139
"2039","was",35003,34,11,32.4,104,25,8,32,1,9,3,0.399999999999999,0.317307692307692,0.24,0.0773076923076923
"2040","was",35012,26,10,38.5,129,15,3,20,1,11,7,18.5,0.232558139534884,0.0833333333333333,0.14922480620155
"2041","was",35023,18,8,44.4,127,33,12,36.4,1,-15,-4,8,0.188976377952756,0.31304347826087,-0.124067100308114
"2042","was",35050,23,6,26.1,119,22,8,36.4,1,1,-2,-10.3,0.151260504201681,0.222222222222222,-0.0709617180205415
"2043","was",35059,34,13,38.2,124,30,12,40,0,4,1,-1.8,0.314516129032258,0.270676691729323,0.0438394373029348
"2044","was",35074,17,5,29.4,88,25,10,40,0,-8,-5,-10.6,0.170454545454545,0.315789473684211,-0.145334928229665
"2045","was",35092,27,10,37,115,36,16,44.4,0,-9,-6,-7.4,0.260869565217391,0.345323741007194,-0.084454175789803
"2046","was",35095,34,17,50,118,34,12,35.3,1,0,5,14.7,0.432203389830508,0.324324324324324,0.107879065506184
"2047","was",35116,34,14,41.2,106,20,7,35,1,14,7,6.2,0.39622641509434,0.203883495145631,0.192342919948709
"2048","was",35132,22,8,36.4,103,18,7,38.9,0,4,1,-2.5,0.233009708737864,0.19811320754717,0.0348965011906943
"2049","was",35148,19,7,36.8,105,26,10,38.5,1,-7,-3,-1.7,0.2,0.297029702970297,-0.097029702970297
"2050","was",35161,26,7,26.9,102,24,8,33.3,0,2,-1,-6.4,0.205882352941176,0.218181818181818,-0.0122994652406417
"2051","den",33950,24,8,33.3,107,19,3,15.8,1,5,5,17.5,0.224299065420561,0.0882352941176471,0.136063771302914
"2052","den",33973,23,6,26.1,113,32,10,31.2,0,-9,-4,-5.1,0.15929203539823,0.260869565217391,-0.101577529819161
"2053","den",33982,22,9,40.9,102,16,4,25,0,6,5,15.9,0.264705882352941,0.114285714285714,0.150420168067227
"2054","den",34007,22,6,27.3,102,22,9,40.9,1,0,-3,-13.6,0.176470588235294,0.272727272727273,-0.0962566844919786
"2055","den",34022,25,7,28,86,20,7,35,0,5,0,-7,0.244186046511628,0.203883495145631,0.0403025513659968
"2056","den",34031,23,11,47.8,123,25,8,32,1,-2,3,15.8,0.268292682926829,0.224299065420561,0.0439936175062685
"2057","den",34042,24,10,41.7,107,24,7,29.2,0,0,3,12.5,0.280373831775701,0.194444444444444,0.0859293873312565
"2058","den",34059,36,13,36.1,101,30,14,46.7,0,6,-1,-10.6,0.386138613861386,0.336,0.0501386138613861
"2059","den",34078,25,9,36,95,18,4,22.2,0,7,5,13.8,0.284210526315789,0.113207547169811,0.171002979145978
"2060","den",34084,29,11,37.9,105,29,8,27.6,0,0,3,10.3,0.314285714285714,0.214285714285714,0.1
"2061","den",34106,17,8,47.1,120,20,8,40,1,-3,0,7.1,0.2,0.230769230769231,-0.0307692307692308
"2062","den",34121,25,4,16,111,23,8,34.8,0,2,-4,-18.8,0.108108108108108,0.212389380530973,-0.104281272422865
"2063","den",34137,22,8,36.4,105,26,7,26.9,1,-4,1,9.5,0.228571428571429,0.230769230769231,-0.00219780219780222
"2064","den",34150,22,10,45.4,110,18,6,33.3,1,4,4,12.1,0.272727272727273,0.168224299065421,0.104502973661852
"2065","den",34161,27,9,33.3,83,26,8,30.8,0,1,1,2.5,0.325301204819277,0.222222222222222,0.103078982597055
"2066","den",34175,34,12,35.3,129,26,13,50,0,8,-1,-14.7,0.27906976744186,0.295454545454545,-0.016384778012685
"2067","den",34186,29,13,44.8,120,25,11,44,1,4,2,0.799999999999997,0.325,0.289473684210526,0.0355263157894737
"2068","den",34213,22,7,31.8,98,24,9,37.5,0,-2,-2,-5.7,0.214285714285714,0.254716981132075,-0.0404312668463612
"2069","den",34230,31,9,29,110,37,17,46,0,-6,-8,-17,0.245454545454545,0.3984375,-0.152982954545455
"2070","den",34237,24,13,54.2,98,25,9,36,0,-1,4,18.2,0.397959183673469,0.257142857142857,0.140816326530612
"2071","den",34244,27,10,37,106,31,11,35.5,1,-4,-1,1.5,0.283018867924528,0.336734693877551,-0.0537158259530227
"2072","den",34263,37,11,29.7,111,26,9,34.6,0,11,2,-4.9,0.297297297297297,0.232758620689655,0.0645386766076421
"2073","den",34272,32,7,21.9,85,19,6,31.6,0,13,1,-9.7,0.247058823529412,0.195652173913043,0.0514066496163683
"2074","den",34287,19,8,42.1,121,27,11,40.7,1,-8,-3,1.4,0.198347107438017,0.292035398230089,-0.093688290792072
"2075","den",34305,25,7,28,92,26,12,46.2,0,-1,-5,-18.2,0.228260869565217,0.321428571428571,-0.0931677018633541
"2076","den",34326,31,15,48.4,132,23,8,34.8,1,8,7,13.6,0.340909090909091,0.2,0.140909090909091
"2077","den",34344,27,10,37,127,23,8,34.8,1,4,2,2.2,0.236220472440945,0.210526315789474,0.0256941566514712
"2078","den",34357,25,13,52,117,25,14,56,1,0,-1,-4,0.333333333333333,0.392523364485981,-0.059190031152648
"2079","den",34366,39,11,28.2,102,36,16,44.4,0,3,-5,-16.2,0.323529411764706,0.403361344537815,-0.0798319327731092
"2080","den",34391,25,8,32,108,25,8,32,0,0,0,0,0.222222222222222,0.220183486238532,0.00203873598369009
"2081","den",34410,31,11,35.5,106,25,9,36,1,6,2,-0.5,0.311320754716981,0.264705882352941,0.0466148723640399
"2082","den",34423,28,10,35.7,105,25,7,28,1,3,3,7.7,0.285714285714286,0.203883495145631,0.0818307905686546
"2083","den",34440,27,11,40.7,122,33,16,48.5,0,-6,-5,-7.8,0.270491803278689,0.387096774193548,-0.11660497091486
"2084","den",34460,35,9,25.7,119,25,11,44,0,10,-2,-18.3,0.226890756302521,0.259842519685039,-0.0329517633825183
"2085","den",34466,38,18,47.4,113,29,11,37.9,0,9,7,9.5,0.47787610619469,0.275,0.20287610619469
"2086","den",34483,25,7,28,99,24,12,50,0,1,-5,-22,0.212121212121212,0.283464566929134,-0.0713433548079217
"2087","den",34495,24,9,37.5,106,36,12,33.3,0,-12,-3,4.2,0.254716981132075,0.297520661157025,-0.0428036800249493
"2088","den",34526,32,15,46.9,140,29,12,41.4,1,3,3,5.5,0.321428571428571,0.321428571428571,0
"2089","den",34557,27,9,33.3,125,25,8,32,1,2,1,1.3,0.216,0.214285714285714,0.00171428571428572
"2090","den",34566,26,11,42.3,127,30,11,36.7,1,-4,0,5.59999999999999,0.259842519685039,0.272727272727273,-0.0128847530422334
"2091","den",34579,31,10,32.3,104,22,9,40.9,0,9,1,-8.6,0.288461538461538,0.228813559322034,0.0596479791395045
"2092","den",34598,24,10,41.7,123,32,10,31.2,1,-8,0,10.5,0.24390243902439,0.306122448979592,-0.0622200099552016
"2093","den",34604,24,7,29.2,108,15,6,40,0,9,1,-10.8,0.194444444444444,0.162162162162162,0.0322822822822823
"2094","den",34618,26,10,38.5,103,22,7,31.8,1,4,3,6.7,0.29126213592233,0.225806451612903,0.0654556843094269
"2095","den",34632,23,9,39.1,127,24,10,41.7,1,-1,-1,-2.6,0.21259842519685,0.25,-0.0374015748031496
"2096","den",34649,25,8,32,123,21,6,28.6,1,4,2,3.4,0.195121951219512,0.160714285714286,0.0344076655052265
"2097","den",34669,27,15,55.6,116,26,12,46.2,0,1,3,9.4,0.387931034482759,0.3,0.0879310344827586
"2098","den",34677,25,9,36,99,30,14,46.7,0,-5,-5,-10.7,0.272727272727273,0.352941176470588,-0.0802139037433156
"2099","den",34692,28,9,32.1,121,24,9,37.5,1,4,0,-5.4,0.223140495867769,0.230769230769231,-0.00762873490146218
"2100","den",34702,26,10,38.5,97,21,10,47.6,0,5,0,-9.1,0.309278350515464,0.247933884297521,0.0613444662179433
"2101","den",34716,28,11,39.3,110,26,8,30.8,1,2,3,8.5,0.3,0.275862068965517,0.0241379310344828
"2102","den",34725,44,13,29.6,106,27,8,29.6,0,17,5,0,0.367924528301887,0.205128205128205,0.162796323173682
"2103","den",34740,32,16,50,131,38,16,42.1,1,-6,0,7.9,0.366412213740458,0.390243902439024,-0.0238316886985664
"2104","den",34751,37,12,32.4,109,30,15,50,0,7,-3,-17.6,0.330275229357798,0.36,-0.0297247706422018
"2105","den",34767,40,24,60,132,32,8,25,1,8,16,35,0.545454545454545,0.218181818181818,0.327272727272727
"2106","den",34782,34,11,32.4,99,18,6,33.3,0,16,5,-0.899999999999999,0.333333333333333,0.160714285714286,0.172619047619048
"2107","den",34795,35,12,34.3,100,14,7,50,0,21,5,-15.7,0.36,0.181034482758621,0.178965517241379
"2108","den",34804,31,14,45.2,129,30,10,33.3,1,1,4,11.9,0.325581395348837,0.275229357798165,0.0503520375506721
"2109","den",34816,34,11,32.4,98,33,11,33.3,0,1,0,-0.899999999999999,0.336734693877551,0.314285714285714,0.0224489795918367
"2110","den",34831,30,13,43.3,125,26,10,38.5,1,4,3,4.8,0.312,0.280373831775701,0.0316261682242991
"2111","den",34840,33,10,30.3,110,18,9,50,1,15,1,-19.7,0.272727272727273,0.275510204081633,-0.00278293135435992
"2112","den",34863,30,9,30,102,27,16,59.3,0,3,-7,-29.3,0.264705882352941,0.428571428571429,-0.163865546218487
"2113","den",34883,30,13,43.3,108,16,6,37.5,1,14,7,5.8,0.361111111111111,0.1875,0.173611111111111
"2114","den",34898,28,13,46.4,113,26,11,42.3,0,2,2,4.1,0.345132743362832,0.268292682926829,0.0768400604360026
"2115","den",34910,31,12,38.7,119,33,12,36.4,1,-2,0,2.3,0.302521008403361,0.363636363636364,-0.0611153552330023
"2116","den",34924,34,9,26.5,105,23,8,34.8,1,11,1,-8.3,0.257142857142857,0.260869565217391,-0.00372670807453418
"2117","den",34938,38,17,44.7,129,20,6,30,1,18,11,14.7,0.395348837209302,0.178217821782178,0.217131015427124
"2118","den",34958,28,15,53.6,129,32,16,50,1,-4,-1,3.6,0.348837209302326,0.421052631578947,-0.0722154222766218
"2119","den",34974,31,10,32.3,105,24,5,20.8,0,7,5,11.5,0.285714285714286,0.137614678899083,0.148099606815203
"2120","den",34988,29,12,41.4,124,38,17,44.7,0,-9,-5,-3.3,0.290322580645161,0.408,-0.117677419354839
"2121","den",35004,26,11,42.3,126,37,15,40.5,1,-11,-4,1.8,0.261904761904762,0.398230088495575,-0.136325326590813
"2122","den",35015,27,7,25.9,125,24,13,54.2,1,3,-6,-28.3,0.168,0.333333333333333,-0.165333333333333
"2123","den",35035,25,6,24,90,27,9,33.3,0,-2,-3,-9.3,0.2,0.234782608695652,-0.0347826086956522
"2124","den",35049,30,9,30,113,27,8,29.6,0,3,1,0.399999999999999,0.238938053097345,0.19672131147541,0.0422167416219353
"2125","den",35067,33,16,48.5,114,36,17,47.2,0,-3,-1,1.3,0.421052631578947,0.418032786885246,0.00301984469370142
"2126","den",35090,20,5,25,116,26,13,50,1,-6,-8,-25,0.129310344827586,0.345132743362832,-0.215822398535246
"2127","den",35098,30,13,43.3,134,32,14,43.8,1,-2,-1,-0.5,0.291044776119403,0.320610687022901,-0.0295659109034977
"2128","den",35108,38,7,18.4,104,34,10,29.4,0,4,-3,-11,0.201923076923077,0.272727272727273,-0.0708041958041958
"2129","den",35124,32,13,40.6,122,23,3,13,1,9,10,27.6,0.319672131147541,0.0849056603773585,0.234766470770183
"2130","den",35138,34,11,32.4,105,25,6,24,0,9,5,8.4,0.314285714285714,0.169811320754717,0.144474393530997
"2131","den",35154,42,18,42.9,109,40,12,30,1,2,6,12.9,0.495412844036697,0.395604395604396,0.0998084484323017
"2132","den",35165,25,7,28,111,25,8,32,1,0,-1,-4,0.189189189189189,0.228571428571429,-0.0393822393822394
"2133","min",33949,18,6,33.3,98,24,11,45.8,0,-6,-5,-12.5,0.183673469387755,0.323529411764706,-0.139855942376951
"2134","min",33974,22,7,31.8,103,26,9,34.6,0,-4,-2,-2.8,0.203883495145631,0.254716981132075,-0.0508334859864444
"2135","min",33992,20,12,60,116,24,4,16.7,1,-4,8,43.3,0.310344827586207,0.15,0.160344827586207
"2136","min",34007,22,9,40.9,99,22,6,27.3,0,0,3,13.6,0.272727272727273,0.176470588235294,0.0962566844919786
"2137","min",34019,19,4,21,92,16,7,43.8,0,3,-3,-22.8,0.130434782608696,0.1875,-0.0570652173913044
"2138","min",34041,28,12,42.9,110,33,12,36.4,0,-5,0,6.5,0.327272727272727,0.302521008403361,0.0247517188693659
"2139","min",34049,23,13,56.5,123,24,8,33.3,1,-1,5,23.2,0.317073170731707,0.224299065420561,0.0927741053111466
"2140","min",34075,22,8,36.4,105,24,11,45.8,0,-2,-3,-9.4,0.228571428571429,0.277310924369748,-0.0487394957983193
"2141","min",34082,27,13,48.2,125,24,8,33.3,1,3,5,14.9,0.312,0.242424242424242,0.0695757575757576
"2142","min",34095,35,15,42.9,108,24,11,45.8,0,11,4,-2.9,0.416666666666667,0.28695652173913,0.129710144927536
"2143","min",34112,25,6,24,110,32,9,28.1,1,-7,-3,-4.1,0.163636363636364,0.313953488372093,-0.150317124735729
"2144","min",34130,22,7,31.8,71,18,2,11.1,0,4,5,20.7,0.295774647887324,0.0645161290322581,0.231258518855066
"2145","min",34145,24,4,16.7,93,38,12,31.6,0,-14,-8,-14.9,0.129032258064516,0.363636363636364,-0.234604105571848
"2146","min",34162,17,3,17.6,96,24,9,37.5,0,-7,-6,-19.9,0.09375,0.230769230769231,-0.137019230769231
"2147","min",34176,22,7,31.8,98,26,6,23.1,1,-4,1,8.7,0.214285714285714,0.211764705882353,0.00252100840336134
"2148","min",34184,35,10,28.6,102,22,11,50,0,13,-1,-21.4,0.294117647058824,0.28695652173913,0.0071611253196931
"2149","min",34198,19,7,36.8,103,18,4,22.2,0,1,3,14.6,0.203883495145631,0.107142857142857,0.0967406380027739
"2150","min",34211,19,4,21,104,32,13,40.6,0,-13,-9,-19.6,0.115384615384615,0.367924528301887,-0.252539912917271
"2151","min",34225,28,10,35.7,114,31,12,38.7,0,-3,-2,-3,0.263157894736842,0.305084745762712,-0.0419268510258698
"2152","min",34232,27,10,37,125,36,14,38.9,1,-9,-4,-1.9,0.24,0.35,-0.11
"2153","min",34259,20,7,35,91,24,11,45.8,0,-4,-4,-10.8,0.230769230769231,0.314285714285714,-0.0835164835164835
"2154","min",34271,28,9,32.1,110,27,12,44.4,0,1,-3,-12.3,0.245454545454545,0.290322580645161,-0.0448680351906159
"2155","min",34282,16,3,18.8,90,29,14,48.3,0,-13,-11,-29.5,0.1,0.358974358974359,-0.258974358974359
"2156","min",34298,24,9,37.5,108,32,13,40.6,0,-8,-4,-3.1,0.25,0.336206896551724,-0.0862068965517241
"2157","min",34310,21,6,28.6,99,15,4,26.7,1,6,2,1.9,0.181818181818182,0.127659574468085,0.0541586073500967
"2158","min",34343,21,7,33.3,109,51,17,33.3,0,-30,-10,0,0.192660550458716,0.459459459459459,-0.266798909000744
"2159","min",34356,19,7,36.8,115,21,9,42.9,1,-2,-2,-6.1,0.182608695652174,0.25,-0.0673913043478261
"2160","min",34370,29,9,31,92,26,7,26.9,1,3,2,4.1,0.293478260869565,0.25,0.0434782608695652
"2161","min",34390,32,12,37.5,105,29,15,51.7,0,3,-3,-14.2,0.342857142857143,0.412844036697248,-0.0699868938401049
"2162","min",34399,12,4,33.3,100,24,8,33.3,0,-12,-4,0,0.12,0.214285714285714,-0.0942857142857143
"2163","min",34408,31,15,48.4,104,32,8,25,1,-1,7,23.4,0.432692307692308,0.266666666666667,0.166025641025641
"2164","min",34423,25,7,28,103,28,10,35.7,0,-3,-3,-7.7,0.203883495145631,0.285714285714286,-0.0818307905686546
"2165","min",34437,25,13,52,116,18,8,44.4,1,7,5,7.6,0.336206896551724,0.242424242424242,0.0937826541274817
"2166","min",34451,23,7,30.4,89,22,6,27.3,0,1,1,3.1,0.235955056179775,0.189473684210526,0.046481371969249
"2167","min",34461,24,7,29.2,91,32,7,21.9,0,-8,0,7.3,0.230769230769231,0.225806451612903,0.00496277915632756
"2168","min",34484,18,7,38.9,105,22,12,54.6,0,-4,-5,-15.7,0.2,0.321428571428571,-0.121428571428571
"2169","min",34496,20,7,35,92,23,8,34.8,0,-3,-1,0.200000000000003,0.228260869565217,0.25531914893617,-0.0270582793709528
"2170","min",34510,16,6,37.5,101,28,13,46.4,1,-12,-7,-8.9,0.178217821782178,0.423913043478261,-0.245695221696083
"2171","min",34522,23,8,34.8,119,42,15,35.7,1,-19,-7,-0.900000000000006,0.201680672268908,0.428571428571429,-0.226890756302521
"2172","min",34536,18,5,27.8,96,20,3,15,1,-2,2,12.8,0.15625,0.104651162790698,0.0515988372093023
"2173","min",34548,21,5,23.8,87,29,12,41.4,0,-8,-7,-17.6,0.172413793103448,0.36734693877551,-0.194933145672062
"2174","min",34565,13,6,46.2,114,18,8,44.4,0,-5,-2,1.8,0.157894736842105,0.19672131147541,-0.0388265746333046
"2175","min",34580,16,5,31.2,104,22,4,18.2,1,-6,1,13,0.144230769230769,0.118811881188119,0.0254188880426504
"2176","min",34604,15,6,40,111,24,7,29.2,1,-9,-1,10.8,0.162162162162162,0.194444444444444,-0.0322822822822823
"2177","min",34619,17,6,35.3,112,19,7,36.8,1,-2,-1,-1.5,0.160714285714286,0.189189189189189,-0.0284749034749035
"2178","min",34631,27,10,37,103,18,10,55.6,0,9,0,-18.6,0.29126213592233,0.275229357798165,0.0160327781241649
"2179","min",34650,20,9,45,129,21,7,33.3,1,-1,2,11.7,0.209302325581395,0.192660550458716,0.0166417751226798
"2180","min",34660,29,12,41.4,111,35,10,28.6,1,-6,2,12.8,0.324324324324324,0.285714285714286,0.0386100386100386
"2181","min",34671,21,7,33.3,97,37,15,40.5,0,-16,-8,-7.2,0.216494845360825,0.36,-0.143505154639175
"2182","min",34688,17,5,29.4,108,26,11,42.3,0,-9,-6,-12.9,0.138888888888889,0.28448275862069,-0.145593869731801
"2183","min",34703,26,10,38.5,99,28,10,35.7,0,-2,0,2.8,0.303030303030303,0.280373831775701,0.0226564712546021
"2184","min",34715,11,5,45.4,113,28,15,53.6,0,-17,-10,-8.2,0.132743362831858,0.391304347826087,-0.258560984994229
"2185","min",34730,19,7,36.8,112,28,11,39.3,1,-9,-4,-2.5,0.1875,0.302752293577982,-0.115252293577982
"2186","min",34744,27,6,22.2,106,25,12,48,0,2,-6,-25.8,0.169811320754717,0.295081967213115,-0.125270646458398
"2187","min",34756,24,6,25,117,25,10,40,1,-1,-4,-15,0.153846153846154,0.337078651685393,-0.183232497839239
"2188","min",34772,23,9,39.1,108,39,13,33.3,0,-16,-4,5.8,0.25,0.336206896551724,-0.0862068965517241
"2189","min",34782,18,6,33.3,112,34,11,32.4,1,-16,-5,0.899999999999999,0.160714285714286,0.333333333333333,-0.172619047619048
"2190","min",34802,13,5,38.5,97,33,8,24.2,1,-20,-3,14.3,0.154639175257732,0.285714285714286,-0.131075110456554
"2191","min",34812,26,9,34.6,130,58,22,37.9,0,-32,-13,-3.3,0.207692307692308,0.464788732394366,-0.257096424702059
"2192","min",34828,23,8,34.8,102,17,6,35.3,1,6,2,-0.5,0.235294117647059,0.204545454545455,0.0307486631016043
"2193","min",34843,16,8,50,107,19,4,21,1,-3,4,29,0.224299065420561,0.15,0.0742990654205608
"2194","min",34865,16,4,25,90,24,6,25,0,-8,-2,0,0.133333333333333,0.185567010309278,-0.052233676975945
"2195","min",34895,20,5,25,107,24,9,37.5,1,-4,-4,-12.5,0.14018691588785,0.296703296703297,-0.156516380815446
"2196","min",34908,14,4,28.6,103,24,7,29.2,1,-10,-3,-0.599999999999998,0.116504854368932,0.205882352941176,-0.0893774985722444
"2197","min",34918,13,5,38.5,95,20,8,40,0,-7,-3,-1.5,0.157894736842105,0.235294117647059,-0.0773993808049536
"2198","min",34935,21,10,47.6,119,26,7,26.9,1,-5,3,20.7,0.252100840336134,0.201923076923077,0.0501777634130575
"2199","min",34946,27,8,29.6,104,33,13,39.4,0,-6,-5,-9.8,0.230769230769231,0.333333333333333,-0.102564102564103
"2200","min",34965,12,2,16.7,105,26,8,30.8,0,-14,-6,-14.1,0.0571428571428571,0.195121951219512,-0.137979094076655
"2201","min",34979,25,9,36,109,30,14,46.7,0,-5,-5,-10.7,0.247706422018349,0.341463414634146,-0.0937569926157977
"2202","min",34996,15,7,46.7,93,24,8,33.3,0,-9,-1,13.4,0.225806451612903,0.24,-0.0141935483870968
"2203","min",35020,21,7,33.3,119,23,14,60.9,0,-2,-7,-27.6,0.176470588235294,0.323076923076923,-0.146606334841629
"2204","min",35026,10,2,20,100,22,11,50,0,-12,-9,-30,0.06,0.294642857142857,-0.234642857142857
"2205","min",35044,20,9,45,115,18,5,27.8,1,2,4,17.2,0.234782608695652,0.131578947368421,0.103203661327231
"2206","min",35063,21,10,47.6,119,27,9,33.3,1,-6,1,14.3,0.252100840336134,0.259615384615385,-0.00751454427925019
"2207","min",35080,25,9,36,117,19,11,57.9,0,6,-2,-21.9,0.230769230769231,0.268292682926829,-0.0375234521575985
"2208","min",35102,19,4,21,107,32,14,43.8,0,-13,-10,-22.8,0.11214953271028,0.347107438016529,-0.234957905306249
"2209","min",35118,18,4,22.2,98,33,14,42.4,0,-15,-10,-20.2,0.122448979591837,0.4,-0.277551020408163
"2210","min",35125,16,7,43.8,113,25,14,56,0,-9,-7,-12.2,0.185840707964602,0.35,-0.164159292035398
"2211","min",35142,16,3,18.8,109,27,10,37,0,-11,-7,-18.2,0.0825688073394495,0.272727272727273,-0.190158465387823
"2212","min",35153,20,5,25,98,22,7,31.8,0,-2,-2,-6.8,0.153061224489796,0.21,-0.0569387755102041
"2213","min",35164,23,11,47.8,118,56,19,33.9,0,-33,-8,13.9,0.279661016949153,0.463414634146341,-0.183753617197189
"2214","min",40241,9,4,44.4,110,32,11,34.4,1,-23,-7,10,0.109090909090909,0.302752293577982,-0.193661384487073
"2215","okl",33951,22,6,27.3,103,24,7,29.2,1,-2,-1,-1.9,0.174757281553398,0.216494845360825,-0.0417375638074267
"2216","okl",33961,21,5,23.8,113,28,5,17.9,1,-7,0,5.9,0.132743362831858,0.136363636363636,-0.00362027353177793
"2217","okl",33980,26,9,34.6,113,32,7,21.9,1,-6,2,12.7,0.238938053097345,0.21875,0.0201880530973451
"2218","okl",34004,20,5,25,85,22,7,31.8,1,-2,-2,-6.8,0.176470588235294,0.253012048192771,-0.0765414599574769
"2219","okl",34009,27,10,37,96,30,14,46.7,0,-3,-4,-9.7,0.3125,0.344262295081967,-0.0317622950819672
"2220","okl",34019,16,7,43.8,112,19,4,21,1,-3,3,22.8,0.1875,0.130434782608696,0.0570652173913044
"2221","okl",34037,28,9,32.1,97,17,4,23.5,1,11,5,8.6,0.278350515463918,0.141176470588235,0.137174044875682
"2222","okl",34052,34,12,35.3,102,26,11,42.3,0,8,1,-7,0.352941176470588,0.294642857142857,0.0582983193277311
"2223","okl",34066,28,16,57.1,108,27,11,40.7,0,1,5,16.4,0.444444444444444,0.3,0.144444444444444
"2224","okl",34081,25,7,28,117,24,11,45.8,0,1,-4,-17.8,0.179487179487179,0.277310924369748,-0.0978237448825684
"2225","okl",34087,27,5,18.5,88,16,5,31.2,0,11,0,-12.7,0.170454545454545,0.144230769230769,0.0262237762237762
"2226","okl",34104,25,12,48,105,40,14,35,1,-15,-2,13,0.342857142857143,0.407766990291262,-0.0649098474341193
"2227","okl",34118,26,7,26.9,124,29,11,37.9,1,-3,-4,-11,0.169354838709677,0.314285714285714,-0.144930875576037
"2228","okl",34135,36,10,27.8,111,22,11,50,0,14,-1,-22.2,0.27027027027027,0.28695652173913,-0.0166862514688602
"2229","okl",34151,27,11,40.7,109,27,14,51.8,0,0,-3,-11.1,0.302752293577982,0.378378378378378,-0.0756260848003967
"2230","okl",34164,25,7,28,101,28,12,42.9,0,-3,-5,-14.9,0.207920792079208,0.310344827586207,-0.102424035506999
"2231","okl",34175,26,13,50,132,34,12,35.3,1,-8,1,14.7,0.295454545454545,0.27906976744186,0.016384778012685
"2232","okl",34182,23,8,34.8,106,19,1,5.3,1,4,7,29.5,0.226415094339623,0.0340909090909091,0.192324185248714
"2233","okl",34195,22,8,36.4,112,19,6,31.6,1,3,2,4.8,0.214285714285714,0.174757281553398,0.0395284327323162
"2234","okl",34210,30,12,40,126,28,10,35.7,1,2,2,4.3,0.285714285714286,0.260869565217391,0.0248447204968944
"2235","okl",34241,28,6,21.4,101,28,6,21.4,1,0,0,0,0.178217821782178,0.195652173913043,-0.0174343521308653
"2236","okl",34247,31,10,32.3,102,22,7,31.8,1,9,3,0.499999999999996,0.294117647058824,0.212121212121212,0.0819964349376114
"2237","okl",34281,28,7,25,99,42,11,26.2,0,-14,-4,-1.2,0.212121212121212,0.323529411764706,-0.111408199643494
"2238","okl",34297,21,3,14.3,99,32,11,34.4,1,-11,-8,-20.1,0.0909090909090909,0.34375,-0.252840909090909
"2239","okl",34313,27,8,29.6,95,23,8,34.8,0,4,0,-5.2,0.252631578947368,0.210526315789474,0.0421052631578948
"2240","okl",34322,19,6,31.6,89,23,13,56.5,0,-4,-7,-24.9,0.202247191011236,0.357798165137615,-0.155550974126379
"2241","okl",34339,16,7,43.8,114,22,8,36.4,1,-6,-1,7.4,0.184210526315789,0.237623762376238,-0.0534132360604481
"2242","okl",34355,35,10,28.6,108,23,9,39.1,0,12,1,-10.5,0.277777777777778,0.245454545454545,0.0323232323232323
"2243","okl",34373,28,11,39.3,121,20,8,40,1,8,3,-0.700000000000003,0.272727272727273,0.218181818181818,0.0545454545454545
"2244","okl",34385,26,11,42.3,117,28,9,32.1,1,-2,2,10.2,0.282051282051282,0.241071428571429,0.0409798534798535
"2245","okl",34399,24,8,33.3,112,12,4,33.3,1,12,4,0,0.214285714285714,0.12,0.0942857142857143
"2246","okl",34413,19,5,26.3,106,23,7,30.4,1,-4,-2,-4.1,0.141509433962264,0.223404255319149,-0.0818948213568848
"2247","okl",34427,22,4,18.2,80,22,13,59.1,0,0,-9,-40.9,0.15,0.342105263157895,-0.192105263157895
"2248","okl",34447,29,10,34.5,114,30,8,26.7,1,-1,2,7.8,0.263157894736842,0.272727272727273,-0.00956937799043062
"2249","okl",34453,27,9,33.3,94,19,7,36.8,0,8,2,-3.5,0.287234042553192,0.214285714285714,0.0729483282674772
"2250","okl",34469,30,9,30,112,24,9,37.5,0,6,0,-7.5,0.241071428571429,0.219512195121951,0.0215592334494774
"2251","okl",34480,30,12,40,116,39,15,38.5,0,-9,-3,1.5,0.310344827586207,0.38135593220339,-0.0710111046171829
"2252","okl",34495,36,12,33.3,121,24,9,37.5,1,12,3,-4.2,0.297520661157025,0.254716981132075,0.0428036800249493
"2253","okl",34509,24,7,29.2,109,19,7,36.8,1,5,0,-7.6,0.192660550458716,0.223404255319149,-0.0307437048604333
"2254","okl",34521,26,8,30.8,103,24,7,29.2,1,2,1,1.6,0.233009708737864,0.221052631578947,0.0119570771589167
"2255","okl",34536,20,3,15,86,18,5,27.8,0,2,-2,-12.8,0.104651162790698,0.15625,-0.0515988372093023
"2256","okl",34550,28,9,32.1,122,24,9,37.5,1,4,0,-5.4,0.221311475409836,0.228813559322034,-0.00750208391219784
"2257","okl",34561,30,10,33.3,98,28,12,42.9,0,2,-2,-9.6,0.306122448979592,0.3,0.00612244897959185
"2258","okl",34574,28,8,28.6,100,21,10,47.6,0,7,-2,-19,0.24,0.247933884297521,-0.00793388429752068
"2259","okl",34613,20,6,30,97,21,5,23.8,1,-1,1,6.2,0.185567010309278,0.157894736842105,0.0276722734671731
"2260","okl",34626,27,10,37,114,27,11,40.7,1,0,-1,-3.7,0.263157894736842,0.314285714285714,-0.0511278195488722
"2261","okl",34630,22,9,40.9,109,26,11,42.3,1,-4,-2,-1.4,0.247706422018349,0.336734693877551,-0.0890282718592024
"2262","okl",34652,26,6,23.1,91,29,8,27.6,0,-3,-2,-4.5,0.197802197802198,0.224299065420561,-0.026496867618363
"2263","okl",34667,28,7,25,94,21,7,33.3,0,7,0,-8.3,0.223404255319149,0.194444444444444,0.0289598108747045
"2264","okl",34680,37,10,27,100,15,6,40,0,22,4,-13,0.3,0.140625,0.159375
"2265","okl",34690,26,13,50,114,19,3,15.8,1,7,10,34.2,0.342105263157895,0.0882352941176471,0.253869969040248
"2266","okl",34707,18,4,22.2,105,28,10,35.7,1,-10,-6,-13.5,0.114285714285714,0.303030303030303,-0.188744588744589
"2267","okl",34710,28,7,25,90,26,8,30.8,0,2,-1,-5.8,0.233333333333333,0.258064516129032,-0.0247311827956989
"2268","okl",34736,27,8,29.6,118,21,10,47.6,1,6,-2,-18,0.203389830508475,0.275229357798165,-0.0718395272896906
"2269","okl",34752,24,6,25,114,31,13,41.9,0,-7,-7,-16.9,0.157894736842105,0.3,-0.142105263157895
"2270","okl",34760,34,7,20.6,98,21,13,61.9,0,13,-6,-41.3,0.214285714285714,0.325,-0.110714285714286
"2271","okl",34785,23,12,52.2,116,21,11,52.4,1,2,1,-0.199999999999996,0.310344827586207,0.314285714285714,-0.00394088669950737
"2272","okl",34801,24,10,41.7,110,35,7,20,1,-11,3,21.7,0.272727272727273,0.225806451612903,0.0469208211143695
"2273","okl",34820,21,6,28.6,118,21,8,38.1,1,0,-2,-9.5,0.152542372881356,0.218181818181818,-0.0656394453004622
"2274","okl",34833,22,15,68.2,109,22,9,40.9,1,0,6,27.3,0.412844036697248,0.254716981132075,0.158127055565172
"2275","okl",34848,29,11,37.9,109,25,10,40,0,4,1,-2.1,0.302752293577982,0.263157894736842,0.0395943988411396
"2276","okl",34856,35,9,25.7,111,21,5,23.8,0,14,4,1.9,0.243243243243243,0.127118644067797,0.116124599175447
"2277","okl",34872,22,2,9.1,89,25,7,28,0,-3,-5,-18.9,0.0674157303370786,0.201923076923077,-0.134507346585998
"2278","okl",34886,25,10,40,121,23,11,47.8,0,2,-1,-7.8,0.247933884297521,0.261904761904762,-0.0139708776072412
"2279","okl",34902,20,6,30,102,19,6,31.6,1,1,0,-1.6,0.176470588235294,0.195652173913043,-0.0191815856777494
"2280","okl",34913,23,8,34.8,112,20,9,45,1,3,-1,-10.2,0.214285714285714,0.259615384615385,-0.0453296703296704
"2281","okl",34940,22,10,45.4,122,24,12,50,1,-2,-2,-4.6,0.245901639344262,0.346153846153846,-0.100252206809584
"2282","okl",34955,25,14,56,123,20,5,25,1,5,9,31,0.341463414634146,0.147058823529412,0.194404591104735
"2283","okl",34968,26,10,38.5,110,21,5,23.8,1,5,5,14.7,0.272727272727273,0.159574468085106,0.113152804642166
"2284","okl",34989,21,4,19,95,33,15,45.4,0,-12,-11,-26.4,0.126315789473684,0.405405405405405,-0.279089615931721
"2285","okl",35002,16,4,25,122,25,8,32,1,-9,-4,-7,0.0983606557377049,0.247422680412371,-0.149062024674666
"2286","okl",35031,30,11,36.7,125,39,20,51.3,0,-9,-9,-14.6,0.264,0.437956204379562,-0.173956204379562
"2287","okl",35040,23,6,26.1,92,29,10,34.5,1,-6,-4,-8.4,0.195652173913043,0.32967032967033,-0.134018155757286
"2288","okl",35052,33,10,30.3,114,30,9,30,1,3,1,0.300000000000001,0.263157894736842,0.254716981132075,0.00844091360476662
"2289","okl",35075,21,6,28.6,95,27,9,33.3,0,-6,-3,-4.7,0.189473684210526,0.27,-0.0805263157894737
"2290","okl",35083,31,12,38.7,101,30,11,36.7,0,1,1,2,0.356435643564356,0.292035398230089,0.0644002453342679
"2291","okl",35099,28,9,32.1,110,18,3,16.7,1,10,6,15.4,0.245454545454545,0.113924050632911,0.131530494821634
"2292","okl",35107,31,14,45.2,103,26,9,34.6,1,5,5,10.6,0.407766990291262,0.27,0.137766990291262
"2293","okl",35126,31,7,22.6,99,18,8,44.4,0,13,-1,-21.8,0.212121212121212,0.2,0.0121212121212121
"2294","okl",35138,25,6,24,106,34,11,32.4,1,-9,-5,-8.4,0.169811320754717,0.314285714285714,-0.144474393530997
"2295","okl",35153,22,7,31.8,100,20,5,25,1,2,2,6.8,0.21,0.153061224489796,0.0569387755102041
"2296","okl",35165,25,8,32,105,25,7,28,0,0,1,4,0.228571428571429,0.189189189189189,0.0393822393822394
"2297","por",33942,19,13,68.4,113,24,8,33.3,1,-5,5,35.1,0.345132743362832,0.230769230769231,0.114363512593601
"2298","por",33957,18,4,22.2,106,29,8,27.6,0,-11,-4,-5.4,0.113207547169811,0.210526315789474,-0.0973187686196623
"2299","por",33973,32,10,31.2,115,23,6,26.1,1,9,4,5.1,0.260869565217391,0.15929203539823,0.101577529819161
"2300","por",33994,39,14,35.9,104,26,10,38.5,0,13,4,-2.6,0.403846153846154,0.236220472440945,0.167625681405209
"2301","por",34003,33,12,36.4,115,16,5,31.2,0,17,7,5.2,0.31304347826087,0.127118644067797,0.185924834193073
"2302","por",34016,31,12,38.7,105,28,10,35.7,1,3,2,3,0.342857142857143,0.315789473684211,0.0270676691729324
"2303","por",34028,33,14,42.4,100,26,6,23.1,1,7,8,19.3,0.42,0.191489361702128,0.228510638297872
"2304","por",34043,31,14,45.2,124,21,7,33.3,1,10,7,11.9,0.338709677419355,0.173553719008264,0.16515595841109
"2305","por",34055,30,6,20,80,32,11,34.4,0,-2,-5,-14.4,0.225,0.297297297297297,-0.0722972972972973
"2306","por",34068,33,13,39.4,122,21,6,28.6,1,12,7,10.8,0.319672131147541,0.15,0.169672131147541
"2307","por",34084,29,8,27.6,112,29,11,37.9,1,0,-3,-10.3,0.214285714285714,0.314285714285714,-0.1
"2308","por",34096,34,9,26.5,88,20,7,35,0,14,2,-8.5,0.306818181818182,0.185840707964602,0.12097747385358
"2309","por",34111,28,10,35.7,109,32,14,43.8,0,-4,-4,-8.09999999999999,0.275229357798165,0.333333333333333,-0.0581039755351682
"2310","por",34117,34,12,35.3,101,24,9,37.5,0,10,3,-2.2,0.356435643564356,0.238938053097345,0.117497590467011
"2311","por",34134,36,15,41.7,129,35,10,28.6,1,1,5,13.1,0.348837209302326,0.275229357798165,0.0736078515041604
"2312","por",34148,22,6,27.3,103,29,9,31,0,-7,-3,-3.7,0.174757281553398,0.252336448598131,-0.0775791670447327
"2313","por",34155,29,13,44.8,125,36,21,58.3,0,-7,-8,-13.5,0.312,0.45985401459854,-0.14785401459854
"2314","por",34177,32,12,37.5,119,23,13,56.5,1,9,-1,-19,0.302521008403361,0.375,-0.0724789915966387
"2315","por",34191,33,12,36.4,114,36,17,47.2,0,-3,-5,-10.8,0.315789473684211,0.392307692307692,-0.0765182186234818
"2316","por",34215,32,12,37.5,131,14,6,42.9,1,18,6,-5.4,0.274809160305344,0.165137614678899,0.109671545626444
"2317","por",34238,24,9,37.5,99,22,6,27.3,1,2,3,10.2,0.272727272727273,0.195652173913043,0.0770750988142292
"2318","por",34248,24,9,37.5,112,23,7,30.4,1,1,2,7.1,0.241071428571429,0.190909090909091,0.0501623376623377
"2319","por",34265,40,17,42.5,107,24,10,41.7,0,16,7,0.799999999999997,0.476635514018692,0.260869565217391,0.2157659488013
"2320","por",34273,28,7,25,86,20,6,30,0,8,1,-5,0.244186046511628,0.204545454545455,0.0396405919661733
"2321","por",34288,37,16,43.2,111,29,15,51.7,0,8,1,-8.5,0.432432432432432,0.38135593220339,0.0510765002290426
"2322","por",34306,21,10,47.6,120,23,11,47.8,0,-2,-1,-0.199999999999996,0.25,0.272727272727273,-0.0227272727272727
"2323","por",34313,23,8,34.8,114,27,8,29.6,1,-4,0,5.2,0.210526315789474,0.252631578947368,-0.0421052631578948
"2324","por",34326,23,8,34.8,120,31,15,48.4,0,-8,-7,-13.6,0.2,0.340909090909091,-0.140909090909091
"2325","por",34345,28,8,28.6,90,28,14,50,0,0,-6,-21.4,0.266666666666667,0.311111111111111,-0.0444444444444445
"2326","por",34368,28,4,14.3,121,23,10,43.5,0,5,-6,-29.2,0.0991735537190083,0.238095238095238,-0.13892168437623
"2327","por",34376,27,10,37,95,31,7,22.6,0,-4,3,14.4,0.315789473684211,0.21875,0.0970394736842105
"2328","por",34394,30,12,40,90,20,12,60,0,10,0,-20,0.4,0.327272727272727,0.0727272727272728
"2329","por",34409,23,8,34.8,91,34,12,35.3,0,-11,-4,-0.5,0.263736263736264,0.378947368421053,-0.115211104684789
"2330","por",34424,25,12,48,102,28,9,32.1,1,-3,3,15.9,0.352941176470588,0.303370786516854,0.0495703899537343
"2331","por",34439,20,6,30,94,22,11,50,0,-2,-5,-20,0.191489361702128,0.3,-0.108510638297872
"2332","por",34451,22,6,27.3,95,23,7,30.4,1,-1,-1,-3.1,0.189473684210526,0.235955056179775,-0.046481371969249
"2333","por",34474,26,12,46.2,117,36,13,36.1,0,-10,-1,10.1,0.307692307692308,0.312,-0.00430769230769229
"2334","por",34482,33,12,36.4,118,31,10,32.3,1,2,2,4.1,0.305084745762712,0.275229357798165,0.0298553879645467
"2335","por",34499,35,15,42.9,124,25,8,32,0,10,7,10.9,0.362903225806452,0.192,0.170903225806452
"2336","por",34517,21,7,33.3,108,24,9,37.5,1,-3,-2,-4.2,0.194444444444444,0.310344827586207,-0.115900383141762
"2337","por",34525,30,10,33.3,102,30,9,30,1,0,1,3.3,0.294117647058824,0.313953488372093,-0.0198358413132695
"2338","por",34538,34,10,29.4,109,18,10,55.6,0,16,0,-26.2,0.275229357798165,0.260869565217391,0.0143597925807739
"2339","por",34554,26,8,30.8,101,23,13,56.5,0,3,-5,-25.7,0.237623762376238,0.325,-0.0873762376237624
"2340","por",34569,31,8,25.8,85,26,11,42.3,0,5,-3,-16.5,0.282352941176471,0.308411214953271,-0.0260582737768004
"2341","por",34581,19,6,31.6,92,29,12,41.4,0,-10,-6,-9.8,0.195652173913043,0.387096774193548,-0.191444600280505
"2342","por",34590,25,10,40,127,35,13,37.1,1,-10,-3,2.9,0.236220472440945,0.317073170731707,-0.0808526982907624
"2343","por",34629,15,4,26.7,105,29,11,37.9,1,-14,-7,-11.2,0.114285714285714,0.336734693877551,-0.222448979591837
"2344","por",34643,35,16,45.7,112,26,9,34.6,1,9,7,11.1,0.428571428571429,0.247706422018349,0.18086500655308
"2345","por",34658,27,10,37,111,26,8,30.8,0,1,2,6.2,0.27027027027027,0.212389380530973,0.0578808897392968
"2346","por",34668,31,11,35.5,115,31,11,35.5,1,0,0,0,0.28695652173913,0.336734693877551,-0.0497781721384206
"2347","por",34694,30,9,30,104,31,17,54.8,0,-1,-8,-24.8,0.259615384615385,0.472222222222222,-0.212606837606838
"2348","por",34707,28,10,35.7,99,18,4,22.2,0,10,6,13.5,0.303030303030303,0.114285714285714,0.188744588744589
"2349","por",34721,28,11,39.3,114,28,12,42.9,1,0,-1,-3.6,0.289473684210526,0.31858407079646,-0.0291103865859338
"2350","por",34738,26,9,34.6,111,30,10,33.3,0,-4,-1,1.3,0.243243243243243,0.25,-0.00675675675675674
"2351","por",34770,42,16,38.1,104,28,8,28.6,0,14,8,9.5,0.461538461538462,0.220183486238532,0.241354975299929
"2352","por",34783,22,9,40.9,88,22,11,50,0,0,-2,-9.1,0.306818181818182,0.297297297297297,0.00952088452088451
"2353","por",34790,19,9,47.4,112,22,7,31.8,1,-3,2,15.6,0.241071428571429,0.203883495145631,0.0371879334257975
"2354","por",34818,21,9,42.9,106,20,7,35,0,1,2,7.9,0.254716981132075,0.1875,0.0672169811320755
"2355","por",34830,25,10,40,113,25,7,28,0,0,3,12,0.265486725663717,0.175,0.0904867256637168
"2356","por",34848,25,10,40,114,29,11,37.9,1,-4,-1,2.1,0.263157894736842,0.302752293577982,-0.0395943988411396
"2357","por",34866,25,16,64,130,30,14,46.7,1,-5,2,17.3,0.369230769230769,0.362068965517241,0.00716180371352787
"2358","por",34886,23,11,47.8,126,25,10,40,1,-2,1,7.8,0.261904761904762,0.247933884297521,0.0139708776072412
"2359","por",34904,21,6,28.6,114,29,11,37.9,1,-8,-5,-9.3,0.157894736842105,0.305555555555556,-0.14766081871345
"2360","por",34923,32,16,50,124,25,12,48,0,7,4,2,0.387096774193548,0.288,0.0990967741935484
"2361","por",34928,22,7,31.8,110,14,5,35.7,1,8,2,-3.9,0.190909090909091,0.148514851485149,0.0423942394239424
"2362","por",34942,32,11,34.4,77,21,6,28.6,0,11,5,5.8,0.428571428571429,0.18,0.248571428571429
"2363","por",34951,22,9,40.9,110,26,11,42.3,1,-4,-2,-1.4,0.245454545454545,0.311320754716981,-0.0658662092624357
"2364","por",34969,18,8,44.4,113,26,7,26.9,1,-8,1,17.5,0.212389380530973,0.216494845360825,-0.0041054648298513
"2365","por",34981,26,13,50,115,31,9,29,1,-5,4,21,0.339130434782609,0.259615384615385,0.079515050167224
"2366","por",34997,21,4,19,90,16,7,43.8,0,5,-3,-24.8,0.133333333333333,0.225806451612903,-0.0924731182795699
"2367","por",35011,21,11,52.4,110,22,5,22.7,1,-1,6,29.7,0.3,0.157894736842105,0.142105263157895
"2368","por",35026,22,11,50,112,10,2,20,1,12,9,30,0.294642857142857,0.06,0.234642857142857
"2369","por",35036,28,12,42.9,97,21,5,23.8,1,7,7,19.1,0.371134020618557,0.185185185185185,0.185948835433372
"2370","por",35049,27,8,29.6,122,30,9,30,1,-3,-1,-0.399999999999999,0.19672131147541,0.238938053097345,-0.0422167416219353
"2371","por",35065,33,13,39.4,117,34,8,23.5,1,-1,5,15.9,0.333333333333333,0.224299065420561,0.109034267912773
"2372","por",35081,37,15,40.5,130,10,3,30,1,27,12,10.5,0.346153846153846,0.0769230769230769,0.269230769230769
"2373","por",35104,26,6,23.1,87,23,13,56.5,0,3,-7,-33.4,0.206896551724138,0.367924528301887,-0.161027976577749
"2374","por",35118,33,14,42.4,105,18,4,22.2,1,15,10,20.2,0.4,0.122448979591837,0.277551020408163
"2375","por",35134,30,13,43.3,101,19,6,31.6,1,11,7,11.7,0.386138613861386,0.209302325581395,0.176836288279991
"2376","por",35149,28,12,42.9,99,21,8,38.1,1,7,4,4.8,0.363636363636364,0.244897959183673,0.11873840445269
"2377","por",35170,30,13,43.3,100,24,8,33.3,0,6,5,10,0.39,0.233009708737864,0.156990291262136
"2378","por",40241,32,11,34.4,109,9,4,44.4,0,23,7,-10,0.302752293577982,0.109090909090909,0.193661384487073
"2379","uta",33942,24,8,33.3,104,19,13,68.4,0,5,-5,-35.1,0.230769230769231,0.345132743362832,-0.114363512593601
"2380","uta",33964,25,6,24,96,23,9,39.1,1,2,-3,-15.1,0.1875,0.303370786516854,-0.115870786516854
"2381","uta",33975,19,7,36.8,75,27,6,22.2,0,-8,1,14.6,0.28,0.204545454545455,0.0754545454545455
"2382","uta",33993,31,15,48.4,106,20,6,30,1,11,9,18.4,0.424528301886792,0.197802197802198,0.226726104084595
"2383","uta",34002,25,12,48,97,26,7,26.9,1,-1,5,21.1,0.371134020618557,0.259259259259259,0.111874761359297
"2384","uta",34017,26,11,42.3,86,20,6,30,0,6,5,12.3,0.383720930232558,0.18,0.203720930232558
"2385","uta",34027,25,8,32,114,20,8,40,1,5,0,-8,0.210526315789474,0.220183486238532,-0.00965717044905845
"2386","uta",34033,19,11,57.9,109,21,7,33.3,1,-2,4,24.6,0.302752293577982,0.25,0.0527522935779817
"2387","uta",34048,34,8,23.5,98,26,8,30.8,0,8,0,-7.3,0.244897959183673,0.230769230769231,0.0141287284144427
"2388","uta",34064,28,7,25,87,20,8,40,1,8,-1,-15,0.241379310344828,0.324324324324324,-0.0829450139794967
"2389","uta",34076,20,6,30,102,17,5,29.4,1,3,1,0.600000000000001,0.176470588235294,0.164835164835165,0.0116354234001293
"2390","uta",34091,28,8,28.6,96,21,8,38.1,0,7,0,-9.5,0.25,0.235294117647059,0.0147058823529412
"2391","uta",34113,25,5,20,77,17,5,29.4,0,8,0,-9.4,0.194805194805195,0.176470588235294,0.0183346065699007
"2392","uta",34124,27,12,44.4,102,32,12,37.5,0,-5,0,6.9,0.352941176470588,0.324324324324324,0.0286168521462639
"2393","uta",34137,26,7,26.9,91,22,8,36.4,0,4,-1,-9.5,0.230769230769231,0.228571428571429,0.00219780219780222
"2394","uta",34161,26,8,30.8,108,27,9,33.3,1,-1,-1,-2.5,0.222222222222222,0.325301204819277,-0.103078982597055
"2395","uta",34171,34,10,29.4,95,25,8,32,1,9,2,-2.6,0.315789473684211,0.352941176470588,-0.0371517027863777
"2396","uta",34198,18,4,22.2,112,19,7,36.8,1,-1,-3,-14.6,0.107142857142857,0.203883495145631,-0.0967406380027739
"2397","uta",34205,28,15,53.6,120,30,11,36.7,1,-2,4,16.9,0.375,0.326732673267327,0.0482673267326733
"2398","uta",34220,30,17,56.7,110,19,8,42.1,0,11,9,14.6,0.463636363636364,0.216216216216216,0.247420147420147
"2399","uta",34237,25,9,36,105,24,13,54.2,1,1,-4,-18.2,0.257142857142857,0.397959183673469,-0.140816326530612
"2400","uta",34253,32,13,40.6,107,14,5,35.7,1,18,8,4.9,0.364485981308411,0.148514851485149,0.215971129823263
"2401","uta",34260,27,12,44.4,112,18,6,33.3,1,9,6,11.1,0.321428571428571,0.171428571428571,0.15
"2402","uta",34275,38,10,26.3,99,29,12,41.4,0,9,-2,-15.1,0.303030303030303,0.339622641509434,-0.0365923384791309
"2403","uta",34294,29,13,44.8,104,26,9,34.6,1,3,4,10.2,0.375,0.321428571428571,0.0535714285714285
"2404","uta",34322,23,13,56.5,109,19,6,31.6,1,4,7,24.9,0.357798165137615,0.202247191011236,0.155550974126379
"2405","uta",34338,22,8,36.4,103,28,12,42.9,1,-6,-4,-6.5,0.233009708737864,0.36,-0.126990291262136
"2406","uta",34347,27,8,29.6,82,23,2,8.7,1,4,6,20.9,0.292682926829268,0.0821917808219178,0.21049114600735
"2407","uta",34367,30,9,30,74,23,9,39.1,0,7,0,-9.1,0.364864864864865,0.259615384615385,0.10524948024948
"2408","uta",34374,27,9,33.3,93,21,10,47.6,0,6,-1,-14.3,0.290322580645161,0.319148936170213,-0.0288263555250515
"2409","uta",34392,27,10,37,98,21,8,38.1,0,6,2,-1.1,0.306122448979592,0.230769230769231,0.0753532182103611
"2410","uta",34415,26,9,34.6,102,16,4,25,1,10,5,9.6,0.264705882352941,0.12,0.144705882352941
"2411","uta",34429,26,15,57.7,100,24,6,25,1,2,9,32.7,0.45,0.216867469879518,0.233132530120482
"2412","uta",34446,20,8,40,91,17,7,41.2,1,3,1,-1.2,0.263736263736264,0.244186046511628,0.0195502172246358
"2413","uta",34455,24,7,29.2,101,27,6,22.2,1,-3,1,7,0.207920792079208,0.202247191011236,0.00567360106797196
"2414","uta",34462,26,11,42.3,104,31,17,54.8,0,-5,-6,-12.5,0.317307692307692,0.443478260869565,-0.126170568561873
"2415","uta",34477,20,7,35,93,21,8,38.1,0,-1,-1,-3.1,0.225806451612903,0.237623762376238,-0.0118173107633344
"2416","uta",34496,23,8,34.8,94,20,7,35,1,3,1,-0.200000000000003,0.25531914893617,0.228260869565217,0.0270582793709528
"2417","uta",34504,23,9,39.1,79,24,9,37.5,0,-1,0,1.6,0.341772151898734,0.306818181818182,0.0349539700805523
"2418","uta",34516,34,13,38.2,100,31,9,29,1,3,4,9.2,0.39,0.293478260869565,0.0965217391304348
"2419","uta",34540,31,16,51.6,110,17,6,35.3,1,14,10,16.3,0.436363636363636,0.233766233766234,0.202597402597403
"2420","uta",34545,26,7,26.9,114,34,12,35.3,1,-8,-5,-8.4,0.184210526315789,0.336448598130841,-0.152238071815052
"2421","uta",34560,23,8,34.8,106,22,5,22.7,1,1,3,12.1,0.226415094339623,0.148514851485149,0.0779002428544741
"2422","uta",34588,23,8,34.8,112,23,8,34.8,1,0,0,0,0.214285714285714,0.224299065420561,-0.0100133511348465
"2423","uta",34599,24,6,25,109,20,10,50,1,4,-4,-25,0.165137614678899,0.3,-0.134862385321101
"2424","uta",34613,21,5,23.8,95,20,6,30,0,1,-1,-6.2,0.157894736842105,0.185567010309278,-0.0276722734671731
"2425","uta",34618,22,7,31.8,93,26,10,38.5,0,-4,-3,-6.7,0.225806451612903,0.29126213592233,-0.0654556843094269
"2426","uta",34633,26,6,23.1,96,14,4,28.6,1,12,2,-5.5,0.1875,0.136363636363636,0.0511363636363636
"2427","uta",34648,25,10,40,95,26,11,42.3,0,-1,-1,-2.3,0.315789473684211,0.323529411764706,-0.00773993808049539
"2428","uta",34678,29,11,37.9,104,23,9,39.1,1,6,2,-1.2,0.317307692307692,0.306818181818182,0.0104895104895105
"2429","uta",34700,33,13,39.4,105,33,13,39.4,1,0,0,0,0.371428571428571,0.397959183673469,-0.0265306122448979
"2430","uta",34712,26,10,38.5,120,17,6,35.3,1,9,4,3.2,0.25,0.189473684210526,0.0605263157894737
"2431","uta",34729,32,14,43.8,127,24,5,20.8,1,8,9,23,0.330708661417323,0.159574468085106,0.171134193332216
"2432","uta",34737,29,13,44.8,105,20,5,25,0,9,8,19.8,0.371428571428571,0.133928571428571,0.2375
"2433","uta",34755,31,8,25.8,104,30,13,43.3,0,1,-5,-17.5,0.230769230769231,0.348214285714286,-0.117445054945055
"2434","uta",34768,23,4,17.4,72,25,9,36,0,-2,-5,-18.6,0.166666666666667,0.306818181818182,-0.140151515151515
"2435","uta",34783,22,11,50,111,22,9,40.9,1,0,2,9.1,0.297297297297297,0.306818181818182,-0.00952088452088451
"2436","uta",34800,23,8,34.8,109,18,7,38.9,1,5,1,-4.1,0.220183486238532,0.221052631578947,-0.000869145340415239
"2437","uta",34817,24,11,45.8,102,22,8,36.4,1,2,3,9.4,0.323529411764706,0.260869565217391,0.0626598465473146
"2438","uta",34833,22,9,40.9,106,22,15,68.2,0,0,-6,-27.3,0.254716981132075,0.412844036697248,-0.158127055565172
"2439","uta",34843,19,4,21,80,16,8,50,0,3,-4,-29,0.15,0.224299065420561,-0.0742990654205608
"2440","uta",34855,26,12,46.2,112,29,7,24.1,1,-3,5,22.1,0.321428571428571,0.216494845360825,0.104933726067747
"2441","uta",34871,33,10,30.3,110,17,8,47.1,1,16,2,-16.8,0.272727272727273,0.220183486238532,0.0525437864887406
"2442","uta",34884,27,10,37,88,33,10,30.3,1,-6,0,6.7,0.340909090909091,0.36144578313253,-0.0205366922234392
"2443","uta",34894,31,12,38.7,115,32,8,25,1,-1,4,13.7,0.31304347826087,0.222222222222222,0.0908212560386474
"2444","uta",34913,20,9,45,104,23,8,34.8,0,-3,1,10.2,0.259615384615385,0.214285714285714,0.0453296703296704
"2445","uta",34936,21,14,66.7,114,30,12,40,1,-9,2,26.7,0.368421052631579,0.333333333333333,0.0350877192982456
"2446","uta",34948,28,13,46.4,97,13,3,23.1,1,15,10,23.3,0.402061855670103,0.108433734939759,0.293628120730344
"2447","uta",34954,21,5,23.8,83,33,9,27.3,0,-12,-4,-3.5,0.180722891566265,0.296703296703297,-0.115980405137032
"2448","uta",34972,25,7,28,86,19,7,36.8,0,6,0,-8.8,0.244186046511628,0.221052631578947,0.0231334149326805
"2449","uta",34986,26,6,23.1,100,20,10,50,0,6,-4,-26.9,0.18,0.280373831775701,-0.100373831775701
"2450","uta",35006,28,7,25,108,21,9,42.9,1,7,-2,-17.9,0.194444444444444,0.267326732673267,-0.0728822882288229
"2451","uta",35022,26,8,30.8,95,27,7,25.9,0,-1,1,4.9,0.252631578947368,0.194444444444444,0.058187134502924
"2452","uta",35042,27,15,55.6,108,25,10,40,1,2,5,15.6,0.416666666666667,0.3,0.116666666666667
"2453","uta",35060,32,13,40.6,112,15,2,13.3,1,17,11,27.3,0.348214285714286,0.0731707317073171,0.275043554006969
"2454","uta",35074,25,10,40,95,17,5,29.4,1,8,5,10.6,0.315789473684211,0.170454545454545,0.145334928229665
"2455","uta",35086,24,9,37.5,103,19,10,52.6,0,5,-1,-15.1,0.262135922330097,0.275229357798165,-0.0130934354680681
"2456","uta",35104,23,13,56.5,106,26,6,23.1,1,-3,7,33.4,0.367924528301887,0.206896551724138,0.161027976577749
"2457","uta",35125,25,14,56,120,16,7,43.8,1,9,7,12.2,0.35,0.185840707964602,0.164159292035398
"2458","uta",35134,19,6,31.6,86,30,13,43.3,0,-11,-7,-11.7,0.209302325581395,0.386138613861386,-0.176836288279991
"2459","uta",35151,35,13,37.1,105,25,9,36,1,10,4,1.1,0.371428571428571,0.272727272727273,0.0987012987012987
"2460","uta",35167,26,10,38.5,101,21,8,38.1,1,5,2,0.399999999999999,0.297029702970297,0.247422680412371,0.0496070225579259
